A Nova	Beira Baixa islands	 Portugal
Abbasak	Persian Gulf	 Iran
Aberdeen	Georgian Bay,  Ontario	 Canada
Abner Cay	Bahamas	 Bahamas
Abruka	Gulf of Riga	 Estonia
Absecon	 New Jersey	 United States
Abu Musa	Persian Gulf	Claimed by  Iran and  United Arab Emirates
Acheron	Great Palm Island,  Queensland	 Australia
Achill		 Ireland
Achillbeg		 Ireland
Acklins	Bahamas	 Bahamas
Acton	Lake Muskoka,  Ontario	 Canada
Adam	Lesser Antilles	 Grenada
Adams	Antarctica	
Adams	 Massachusetts	 United States
Adams	Auckland Islands	 New Zealand
Adams	 Nunavut	 Canada
Adams Key	Florida Keys,  Florida	 United States
Adderly Cay	Bahamas	 Bahamas
Adelaide	Marguerite Bay off the west coast of the Antarctic Peninsula	Antarctica
Adelaide	St. Lawrence River,  Ontario	 Canada
Adelsö	Lake Mälaren	 Sweden
Adhelfopoulo	Sporades	 Greece
Admiralty	 Alaska	 United States
Admiralty	 Nunavut	 Canada
Admiralty	Saint Lawrence River,  Ontario	 Canada
Æbelø	The Kattegat	 Denmark
Aegina	Saronic Islands	 Greece
Aegna	Tallinn Bay, Baltic Sea	 Estonia
Ærø	Baltic Sea	 Denmark
Agar's	 Bermuda	 United Kingdom
Agathonisi	Dodecanese	 Greece
Agatti	Lakshadweep	 India
Agerø	Limfjord	 Denmark
Agersø	Great Belt	 Denmark
Agios Efstratios		 Greece
Agnes	 Queensland	 Australia
Agolada	Ribatejo islands	 Portugal
Agrihan	 Northern Mariana Islands	 United States
Agunijima	Okinawa Islands part of the Ryukyu Islands	 Japan
Ahe	King George Islands,  Tuamotus,  French Polynesia	 France
Ahelaid	Väinameri Sea	 Estonia
Cayo Ahogado	Greater Antilles, Puerto Rico	 United States
Ahtra	Pärnu Bay, Gulf of Riga	 Estonia
Ailinginae	Ralik Chain	 Marshall Islands
Ailinginae Atoll	Ralik Chain	 Marshall Islands
Ailinglapalap	Ralik Chain	 Marshall Islands
Ailinglapalap Atoll	Ralik Chain	 Marshall Islands
Ailuk	Ratak Chain	 Marshall Islands
Ailuk Atoll	Ratak Chain	 Marshall Islands
Air Force	Queen Elizabeth Islands,  Nunavut	 Canada
Aipus	Torres Strait Islands  Queensland	 Australia
Aitutaki	Cook Islands	 Cook Islands
Ajeltokrok	Arno Atoll	 Marshall Islands
Ajirah	Hawar Islands	 Bahrain
Akajima	Kerama Islands part of the Okinawa Islands part of the Ryukyu Islands	 Japan
Akimiski	James Bay,  Nunavut	 Canada
Akpatok	Queen Elizabeth Islands,  Nunavut	 Canada
Aksi	Gulf of Finland	 Estonia
Akusekijima	Tokara Islands part of the Satsunan Islands part of the Ryukyu Islands	 Japan
Aikin	 Alabama	 United States
Al Hajiyat	Hawar Islands	 Bahrain
Al Wakur	Hawar Islands	 Bahrain
Alameda	Islands of San Francisco Bay,  California	 United States
Åland	Archipelago Sea,  Åland Islands	 Finland
Albany	Torres Strait Islands  Queensland	 Australia
Albatross	 Tasmania	 Australia
Isla de Alborán	Plazas de Soberanía, Strait of Gibraltar	Disputed between  Spain and  Morocco
Alcarraza	Greater Antilles,  Puerto Rico	 United States
Alcatraz	Islands of San Francisco Bay,  California	 United States
Alcorn	Moon Lake,  Mississippi	 United States
Alcsi-sziget	Tisza	 Hungary
Alder Cay	Bahamas	 Bahamas
Alderney	Channel Islands	 Crown dependency
Alegranza	 Canary Islands	 Spain
Alejandro Selkirk	Juan Fernández archipelago	 Chile
Alexander	Queen Elizabeth Islands,  Nunavut	 Canada
Cayo Alfenique	Greater Antilles,  Puerto Rico	 United States
Alger	Fulton Chain Lakes,  New York	 United States
Cayo Algodones	Greater Antilles,  Puerto Rico	 United States
Alicudi	Aeolian Islands	 Italy
Alimia	Dodecanese	 Greece
All Awash	Lesser Antilles	 Saint Vincent and the Grenadines
Allan Cays	Bahamas	 Bahamas
Allans Cay	Bahamas	 Bahamas
Alligator	 Alabama	 United States
Allirahu	Gulf of Riga	 Estonia
Allison	Torres Strait Islands,  Queensland	 Australia
Almourol	Ribatejo islands	 Portugal
Alnön		 Sweden
Alonissos	Sporades	 Greece
Alpha	 Bermuda	 United Kingdom
Als	Baltic Sea	 Denmark
Alumine Vaika	Vaika Islands	 Estonia
Isla Altamuria	 Sinaloa	 Mexico
Alty	 Delaware	 United States
Amager	Øresund	 Denmark
Amami Ōshima	Amami Islands part of the Satsunan Islands part of the Ryukyu Islands	 Japan
Amanu	 Tuamotus,  French Polynesia	 France
Ambae	Pacific Ocean	 Vanuatu
Ambergris Cay	Bahamas	 Bahamas
Ambrym	New Hebrides	 Vanuatu
Ambu	Arabian Sea	 India
Amedroz	North Channel,  Ontario	 Canada
Ameland	West Frisian Islands	 Netherlands
Amelia	Sea Islands,  Florida	 United States
Amherst	Lake Ontario,  Ontario	 Canada
Amini	Lakshadweep	 India
Ammerön		 Sweden
Amores	Minho islands	 Portugal
Amorgos	Cyclades	 Greece
Amoroso	Beira Litoral Islands	 Portugal
Åmøy		 Norway
Amrita	 Massachusetts	 United States
Amrum	North Frisian Islands	 Germany
Amsterdam	Indian Ocean	 France
Amund Ringnes Island	Sverdrup Islands group of the Queen Elizabeth Islands,  Nunavut	 Canada
Amygdaloid	Lake Superior,  Michigan	 United States
Anacapa	 Channel Islands of California	 United States
Anafi	Cyclades	 Greece
Anastasia	Matanzas River,  Florida	 United States
Anatahan	 Northern Mariana Islands	 United States
Anaho	Pyramid Lake,  Nevada	 United States
Anatom	Pacific Ocean	 Vanuatu
Anchor	Torres Strait Islands,  Queensland	 Australia
Andalusia	Mississippi River,  Illinois	 United States
Anderson Cay	Bahamas	 Bahamas
Anderson's Ledge	Isles of Shoals,  New Hampshire	 United States
Anderson	Puget Sound,  Washington	 United States
Andørja		 Norway
Andøy	Vesterålen	 Norway
Andrott	Lakshadweep	 India
Andros	Cyclades	 Greece
Andros	Bahamas	 Bahamas
Anegada	Lesser Antilles,  British Virgin Islands	 United Kingdom
Angel Cays	Bahamas	 Bahamas
Isla Ángel de la Guarda	 Baja California	 Mexico
Angel	Islands of San Francisco Bay,  California	 United States
Angijak	 Nunavut	 Canada
Angistri		 Greece
Angle Cay	Bahamas	 Bahamas
Angoche		 Mozambique
Anglesey	North Wales	 Wales
Anguila	Bahamas	 Bahamas
Anguilla 	Leeward Islands of the Lesser Antilles	British Overseas Territory of the  United Kingdom
Anguillita	Leeward Islands of the Lesser Antilles,  Anguilla	British Overseas Territory of the  United Kingdom
Anholt	the Kattegat	 Denmark
Aniwa	Pacific Ocean	 Vanuatu
Anjouan	Comoros	 Comoros
Anna Cay	Bahamas	 Bahamas
Annacis	Fraser River,  British Columbia	 Canada
Annobon	Gulf of Guinea	 Equatorial Guinea
Anticosti	Saint Lawrence River,  Quebec	 Canada
Antigua	Leeward Islands	 Antigua and Barbuda
Antikythera		 Greece
Antelope	 Arizona	 United States
Antelope	Great Salt Lake,  Utah	 United States
Antiparos	Cyclades	 Greece
Antipsara		 Greece
Anuanuraro	Duke of Gloucester Islands,  Tuamotus,  French Polynesia	 France
Anuanurunga	Duke of Gloucester Islands,  Tuamotus,  French Polynesia	 France
Anuta	Melanesia	 Solomon Islands
Anydros	Cyclades	 Greece
Aoba	Pacific Ocean	 Vanuatu
Aogashima	Izu Islands	 Japan
Apataki	Palliser Islands,  Tuamotus,  French Polynesia	 France
Aplin	 Queensland	 Australia
Appledore	Isles of Shoals,  Maine	 United States
Aquidneck	Aquidneck Island,  Rhode Island	 United States
Aragusuku	Yaeyama Islands part of the Sakishima Islands part of the Ryukyu Islands	 Japan
Aranysziget	Tisza	 Hungary
Araura	Cook Islands	 Cook Islands
Araway Cay	Bahamas	 Bahamas
Arbuckle	 Arkansas	 United States
Archer	 Arkansas	 United States
Archers Cay	Bahamas	 Bahamas
Arden	Torres Strait Islands,  Queensland	 Australia
Ardy More	Lower Lough Erne	 Ireland
Cayo Arenas	Greater Antilles,  Puerto Rico	 United States
Argyle	Lake Huron,  Ontario	 Canada
Ariana	Alentejo Islands	 Portugal
Aristazabal	 British Columbia	 Canada
Arizona	 Wyoming	 United States
Arkiko	Red Sea	 Eritrea
Arkoi	Dodecanese	 Greece
Armathia	Dodecanese	 Greece
Armona Island	Algarve islands	 Portugal
Armstrong	Holston River,  Tennessee	 United States
Arnold	 Queensland	 Australia
Arnøy		 Norway
Årø	Little Belt	 Denmark
Arøya		 Norway
Arran	Scotland	 Scotland
Arranmore	County Donegal	 Ireland
Arsenal	Mississippi River,  Illinois	 United States
Aruba 	Lesser Antilles	 Kingdom of the Netherlands
Aruro	Lake Abaya	 Ethiopia
Arutua	Palliser Islands,  Tuamotus,  French Polynesia	 France
Ascension		 British overseas territory of  Saint Helena, Ascension and Tristan da Cunha
Ascrib		 Scotland
Ash	Willamette River,  Oregon	 United States
Asinara	 Sardinia	 Italy
Askø		 Denmark
Asperö	Southern Gothenburg Archipelago	 Sweden
Assateague	 Maryland and  Virginia	 United States
Astakida	Dodecanese	 Greece
Astipálaia	Dodecanese	 Greece
Asuncion	 Northern Mariana Islands	 United States
Atholl	Bahamas	 Bahamas
Atiu	Cook Islands	 Cook Islands
Atkinson	Galveston Bay,  Texas	 United States
Atløy		 Norway
Attu	Aleutian Islands	 United States
Atwood Cay	Bahamas	 Bahamas
Aubrey	St. Lawrence River,  Ontario	 Canada
Aubussi	Torres Strait Islands,  Queensland	 Australia
Auckland	Auckland Islands	 New Zealand
Aughinish	County Clare	 Ireland
Aughinish	County Limerick	 Ireland
August Cay	Bahamas	 Bahamas
Auhah	Persian Gulf	 Kuwait
Aukane	Torres Strait Islands,  Queensland	 Australia
Aulneau	St. Lawrence River,  Ontario	 Canada
Aur Atoll	Ratak Chain	 Marshall Islands
Aureed	Torres Strait Islands,  Queensland	 Australia
Auskerry	The North Isles,  Orkney Islands	 Scotland
Australia	Australia,  Australia	 Australia
Austvågøy	Lofoten	 Norway
Aux Herbes	Mississippi Sound,  Alabama	 United States
Avernakø		 Denmark
Averøy		 Norway
Avery	 Louisiana	 United States
Avsa	Marmara Islands	 Turkey
Axel Heiberg	Sverdrup Islands group of the Queen Elizabeth Islands,  Nunavut	 Canada
Azenha Brava	Alentejo islands	 Portugal
Bacelos	Alentejo Islands, Alentejo	 Portugal
Bacelos Pequena	Alentejo Islands, Alentejo	 Portugal
Badgely	Georgian Bay,  Ontario	 Canada
Badger Island	Great Salt Lake,  Utah	 United States
Badger	Lake Winnipesaukee,  New Hampshire	 United States
Baffin	 Nunavut	 Canada
Bågø	Islands of the Little Belt	 Denmark
Bahrain Island	Persian Gulf	 Bahrain
Baillie-Hamilton	 Nunavut	 Canada
Bainbridge	Puget Sound,  Washington	 United States
Baker	Allegheny River,  Pennsylvania	 United States
Bald Eagle	Allegheny River,  Pennsylvania	 United States
Baleal	Estremadura islands	 Portugal
Bali	Lesser Sunda Islands	 Indonesia
Balta	 Shetland Islands	 Scotland
Baltrum	East Frisian Islands	 Germany
Baluan	Admiralty Islands	 Papua New Guinea
Bananec	Glénan islands	 France
Banfills	Mississippi River,  Minnesota	 United States
Bangaram	Lakshadweep	 India
Banks	 Northwest Territories	 Canada
Baranof	Alexander Archipelago,  Alaska	 United States
Barbadoes	Schuylkill River,  Pennsylvania	 United States
Barbados	Caribbean Sea	 Barbados
Bardwell	Illinois River,  Illinois	 United States
Barents Island	Svalbard	 Norway
Barentsøya	Svalbard	 Norway
Barkis	Mississippi River,  Illinois	 United States
Barnes	San Juan Islands,  Washington	 United States
Barnston	Fraser River,  British Columbia	 Canada
Barra	Outer Hebrides	 Scotland
Barren	 Falkland Islands	 United Kingdom
Barren	North Channel,  Ontario	 Canada
Barreta	Algarve islands	 Portugal
Barrie	North Channel,  Ontario	 Canada
Barrier	Georgian Bay,  Ontario	 Canada
Barro	Algarve islands	 Portugal
Barsø	Islands of the Little Belt	 Denmark
Barter	Arctic Sea,  Alaska	 United States
Bartlett	 Maine	 United States
Basse-Terre	 Guadeloupe, Lesser Antilles	 France
Bassett	Lake Ontario,  Ontario	 Canada
Bassett	Lake Saint Clair,  Ontario	 Canada
Batanta	Raja Ampat Islands	 Indonesia
Bateau	Georgian Bay,  Ontario	 Canada
Bateman	 Louisiana	 United States
Bateman	 Washington	 United States
Bathurst	Queen Elizabeth Islands,  Nunavut	 Canada
Batture	North Channel,  Ontario	 Canada
Batz		 France
Bazaruto	Bazaruto Archipelago	 Mozambique
Beals	 Maine	 United States
Beament	Lake Huron,  Ontario	 Canada
Bear	Lake Temagami,  Ontario	 Canada
Bear	Lake Winnipesaukee,  New Hampshire	 United States
Bear	Suncook River,  New Hampshire	 United States
Bears Back	North Channel,  Ontario	 Canada
Bears Rump	Georgian Bay,  Ontario	 Canada
Beata	Pedernales	 Dominican Republic
Beauchene	 Falkland Islands	 United Kingdom
Beaupre	Cranberry Lake,  Ontario	 Canada
Beauregard	Barataria Bay,  Louisiana	 United States
Beaurivage	St. Lawrence River,  Ontario	 Canada
Beausoleil	Georgian Bay,  Ontario	 Canada
Beauty	North Channel,  Ontario	 Canada
Beaver		Antarctica
Beaver	 Falkland Islands	 United Kingdom
Beaver	Mississippi River,  Iowa	 United States
Beaver	North Channel,  Ontario	 Canada
Beaver	Beaver Island archipelago,  Michigan	 United States
Beaver	Isle Royale,  Michigan	 United States
Beaver	 Massachusetts	 United States
Beaver	Lake Winnipesaukee,  New Hampshire	 United States
Beaver	Rio Grande,  Tamaulipas	 Mexico
Beaverdam	Arkansas River,  Arkansas	 United States
Beckwith	Georgian Bay,  Ontario	 Canada
Belene	Danube River	 Bulgaria
Bell	 Newfoundland and Labrador	 Canada
Belle Île		 France
Belle Isle	 Louisiana	 United States
Belleau	North Channel,  Ontario	 Canada
Bellinghausen	Windward Islands, Society Islands,  French Polynesia	Overseas Lands of  France
Benbecula	Outer Hebrides	 Scotland
Benguerra	Bazaruto Archipelago	 Mozambique
Bennett	De Long Islands,  Alaska	Claimed by the  United States, controlled by  Russia
Bere	Bantry Bay	 Ireland
Bergmann	Mississippi River,  Wisconsin	 United States
Berlenga Grande	Berlengas	 Portugal
Bermuda	 The Bermuda Islands	 United Kingdom
Big	Baffin Island,  Nunavut	 Canada
Big	Hudson Bay,  Nunavut	 Canada
Big	James Bay,  Nunavut	 Canada
Big	Lake Chemong,  Ontario	 Canada
Big	Lake Vernon,  Ontario	 Canada
Big	Pigeon Lake,  Ontario	 Canada
Big	Bay of Quinte,  Ontario	 Canada
Big	Skootamatta Lake,  Ontario	 Canada
Big	Lake of the Woods,  Ontario	 Canada
Big	Barataria Bay, Louisiana	 United States
Big	(Disambiguation page)	 Canada
Big	(Disambiguation page)	 United States
Big Blue	Illinois River,  Illinois	 United States
Big Burnt	Georgian Bay,  Ontario	 Canada
Big Chicken	Lake Erie,  Ontario	 Canada
Bigga	 Shetland Islands	 Scotland
Bighorn	Lake Mead,  Nevada	 United States
Bigsby	Lake of the Woods,  Ontario	 Canada
Bigwin	Lake Muskoka,  Ontario	 Canada
Bikar	Bikar Atoll, Ratak Chain	 Marshall Islands
Bikini	Bikini Atoll	 Marshall Islands
Billingsgate	Cape Cod Bay,  Massachusetts	 United States
Bioko	Gulf of Guinea	 Equatorial Guinea
Birch	Lake Winnipesaukee,  New Hampshire	 United States
Birch Hill	Lake Winnipesaukee,  New Hampshire	 United States
Bird	Algoa Bay	 South Africa
Bird	Caribbean Sea	disputed by  Venezuela and  Dominica
Bird	Whitsunday Islands,  Queensland	 Australia
Bird	North Queensland,  Queensland	 Australia
Bird	Seychelles	 Seychelles
Bird	 South Georgia	 United Kingdom
Bird	Buzzards Bay,  Massachusetts	 United States
Bird	Fox Islands group of the Aleutian Islands,  Alaska	 United States
Bird	Lake Zway	 Ethiopia
Bird Island	Lesser Antilles	 Antigua and Barbuda
Birkholm	Islands of the waters south of Funen	 Denmark
Björkö	Lake Mälaren	 Sweden
Biševo	Adriatic Sea	 Croatia
Bishop Rock	Isles of Scilly	 United Kingdom
Bishop Island	Lesser Antilles	 Antigua and Barbuda
Bitra	Lakshadweep	 India
Bjørnø	Islands of the waters south of Funen	 Denmark
Bjørnøya	Svalbard	 Norway
Black	Lake Abitibi,  Ontario	 Canada
Black Fox	Allegheny River,  Pennsylvania	 United States
Black Prince	 Louisiana	 United States
Black Rock		
Blake Island	Lesser Antilles	 Antigua and Barbuda
Blakeley	Mobile Bay,  Alabama	 United States
Blakely	San Juan Islands,  Washington	 United States
Blaker Towhead	Mississippi River,  Tennessee	 United States
Blanchard	Mississippi River,  Illinois	 United States
Bleaker	 Falkland Islands	 United Kingdom
Bleanish	Lough Erne	 Ireland
Blennerhassett	Ohio River,  West Virginia	 United States
Blind	San Juan Islands,  Washington	 United States
Block	Atlantic Ocean,  Rhode Island	 United States
Blueberry Island	Lake Wanapitei,  Ontario	 Canada
Boega	Minho islands	 Portugal
Bogø	Baltic Sea	 Denmark
Bogoslof Island	Bering Sea,  Alaska	 United States
Bois Blanc	Detroit River,  Ontario	 Canada
Bois Blanc	Lake Huron,  Michigan	 United States
Bokak Atoll	Ratak Chain	 Marshall Islands
Bokissa	Pacific Ocean	 Vanuatu
Bolama	Bissagos Islands	 Guinea-Bissau
Bolivar	 Texas	 United States
Bolter	Mississippi River,  Illinois	 United States
Bømlo		 Norway
Bonaire 	Lesser Antilles	 Netherlands
Bonanza	Lake Wanapitei,  Ontario	 Canada
Bone	Georgian Bay,  Ontario	 Canada
Bonhomme	Missouri River,  Missouri	 United States
Bonnet Carre	Mississippi River,  Louisiana	 United States
Bora Bora	Windward Islands, Society Islands,  French Polynesia	Overseas Lands of  France
Borden	Queen Elizabeth Islands,  Nunavut	 Canada
Borðoy	 Faroe Islands	 Denmark
Borkum	East Frisian Islands	 Germany
Borneo	Malay archipelago	Divided between  Indonesia,  Malaysia, and  Brunei
Bornholm	Baltic Sea	 Denmark
Borradaile	Balleny Islands	Ross Dependency,  New Zealand
Bourinot	North Channel,  Ontario	 Canada
Bouvetoya	South Atlantic Ocean	 Norway
Bowen	Gulf Islands,  British Columbia	 Canada
Boyd	Holston River,  Tennessee	 United States
Bozcaada	Aegean Islands	 Turkey
Brač	Adriatic Sea	 Croatia
Brandsø	Islands of the Little Belt	 Denmark
Brännö	Southern Gothenburg Archipelago	 Sweden
Brant	Mississippi River Delta,  Louisiana	 United States
Bray	 Nunavut	 Canada
Brecqhou	Brechou Channel Islands	 Crown dependency
Breeze	Stoney Lake,  Ontario	 Canada
Breezy	Lake Winnipesaukee,  New Hampshire	 United States
Bréhat		 France
Bremangerlandet		 Norway
Bressay	 Shetland Islands	 Scotland
Bridgeman	South Shetland Islands	Claimed by Argentine Antarctica,  Argentina,
 Antártica Chilena Province of  Chile,
and the  British Antarctic Territory of the United Kingdom
Brijuni	Adriatic Sea	 Croatia
Broadview	Gloucester Pool,  Ontario	 Canada
Brodeur	Lake Superior,  Ontario	 Canada
Brother	Niagara River,  New York	 United States
Brother	 Shetland Islands	 Scotland
Browns Island	Great Salt Lake,  Utah	 United States
Brown	San Juan Islands,  Washington	 United States
Browning	Lake Muskoka,  Ontario	 Canada
Browns	 Louisiana	 United States
Browns	 West Virginia	 United States
Brownscombe	Stoney Lake,  Ontario	 Canada
Brunec	Glénan islands	 France
Brunot	Ohio River,  Pennsylvania	 United States
Bruny	 Tasmania	 Australia
Bruray	Outer Skerries,  Shetland Islands	 Scotland
Brush	Timbalier Bay,  Louisiana	 United States
Bryher	Isles of Scilly	 United Kingdom
Bu Sadah	Hawar Islands	 Bahrain
Bu Tammur	Hawar Islands	 Bahrain
Bubaque	Bissagos Islands	 Guinea-Bissau
Bubiyan	Persian Gulf	 Kuwait
Buchhorst	Trave river	 Germany
Buck	 U.S. Virgin Islands	 United States
Buckle	Balleny Islands	Ross Dependency,  New Zealand
Buckley	 West Virginia	 United States
Buffington	 West Virginia	 United States
Bugio	Estremadura islands	 Portugal
Bugio	 Madeira	 Portugal
Buláti-sziget	Tisza	 Hungary
Buldir	Aleutian Islands,  Alaska	 United States
Bull	Dublin Bay	 Ireland
Bull	Atlantic Ocean,  South Carolina	 United States
Bulla	Caspian Sea	 Azerbaijan
Bunce	Sierra Leone River	 Sierra Leone
Buneh	Persian Gulf	Claimed by Iran
Buøy	Island in Øyane archipelago, Stavanger municipality, Rogaland	 Norway
Burano	Venetian Lagoon	 Italy
Burgazada	Prince's Islands	 Turkey
Burhou	Channel Islands	 Guernsey
Burke Island	Lake Huron,  Ontario	 Canada
Burlington	Mississippi River,  Illinois	 United States
Burlington	Delaware River,  New Jersey	 United States
Burns	Tennessee River,  Tennessee	 United States
Burnt	Lake Nipissing,  Ontario	 Canada
Burnt	Windy Lake,  Ontario	 Canada
Burra	 Shetland Islands	 Scotland
Burray	 Orkney Islands	 Scotland
Burrit	Lake Nipissing,  Ontario	 Canada
Burton	Lake Champlain,  Vermont	 United States
Bushes	Platte River,  Nebraska	 United States
Bussell	Tennessee River,  Tennessee	 United States
Bustard	Georgian Bay,  Ontario	 Canada
Butler	Lake Champlain,  Vermont	 United States
Büyükada	Princes' Islands	 Turkey
Buzzard	Mississippi River,  Illinois	 United States
Byan Martin	 Nunavut	 Canada
Bylot	 Nunavut	 Canada
Caballo	Manila Bay	 Philippines
Cabanaas	Algarve islands	 Portugal
Cabbage	Holston River,  Tennessee	 United States
Cabrera	 Balearic Islands	 Spain
Cacela da Abóbora	Algarve islands	 Portugal
Cacela	Algarve islands	 Portugal
Caillou	Timbalier Bay, Louisiana	 United States
Caja de Muertos	 Puerto Rico	 United States
Calayan	Babuyan Islands, Cagayan	 Philippines
Calf of Eday	The North Isles,  Orkney Islands	 United Kingdom, Scotland
Calf of Flotta	The South Isles,  Orkney Islands	 United Kingdom, Scotland
Calf of Man	 Isle of Man	 Crown dependency
Callinan	Stoney Lake,  Ontario	 Canada
Calumet	Timbalier Bay,  Louisiana	 United States
Calvert	 British Columbia	 Canada
Cambalhão	Estremadura islands	 Portugal
Camelot	St. Lawrence River,  Ontario	 Canada
Cameron	 Nunavut	 Canada
Cameron	Lake Joseph,  Ontario	 Canada
Camiguin	Babuyan Islands, Cagayan	 Philippines
Camorta	Central group of the Nicobar Islands	 India
Camp	Lake Winnipesaukee,  New Hampshire	 United States
Campania	 British Columbia	 Canada
Campbell	Torres Strait Islands,  Queensland	 Australia
Campbell	Campbell Islands	 New Zealand
Campbell	 British Columbia	 Canada
Campbells	Mississippi River,  Illinois	 United States
Campobello	 New Brunswick	 Canada
Cancún	Caribbean Sea,  Quintana Roo	 Mexico
Candlana Bar	Willamette River,  Oregon	 United States
Canna	Inner Hebrides	 United Kingdom, Scotland
Isla del Caño	Bahia de Coronado	 Costa Rica
Canon Rock		Northern Ireland
Cantin	French River,  Ontario	 Canada
Cape Barren	Furneaux Group, Bass Strait,  Tasmania	 Australia
Cape Breton	 Nova Scotia	 Canada
Capraia	Tuscan Archipelago	 Italy
Caprara	Tremiti Islands	 Italy
Caprera	Maddalena archipelago,  Sardinia	 Italy
Capri	Gulf of Naples	 Italy
Car	Lower Lough Erne	 Ireland
Car Nicobar	Northern group of the Nicobar Islands	 India
Cara	Inner Hebrides	 United Kingdom, Scotland
Carcass	 Falkland Islands	 United Kingdom
Isla Carmen	Baja California Sur	 Mexico
Carmen	Laguna de Términos,  Campeche	 Mexico
Carmines	York River,  Virginia	 United States
Carmona	Beira Baixa islands	 Portugal
Caroline	Line Islands	 Kiribati
Carpmael	Georgian Bay,  Ontario	 Canada
Carrington	Great Salt Lake,  Utah	 United States
Carroll	Mississippi River,  Illinois	 United States
Isla de la Cartuja	Guadalquivir River, Seville,  Andalusia	 Spain
Cascalheira	Alentejo islands	 Portugal
Casse-Tete	Timbalier Bay,  Louisiana	 United States
Cast-off	Allegheny River,  Pennsylvania	 United States
Cat	Bahamas	 Bahamas
Cat	Mascarene Islands	 Mauritius
Cat	Mississippi River,  Arkansas	 United States
Cat	Apostle Islands,  Wisconsin	 United States
Cat	Gulf Coast,  Mississippi	 United States
Catalina	Channel Islands of California,  California	 United States
Catalina De La Romana	La Romana	 Dominican Republic
Çatalada	Aegean Sea	 Turkey
Catanduanes	Catanduanes, Luzon	 Philippines
Catfish	Missouri River,  Missouri	 United States
Caye Caulker	Caribbean Sea	 Belize
Cava	 Orkney Islands	 United Kingdom, Scotland
Caviana	Mouth of the Amazon River,  Pará	 Brazil
Cavus adasi	Kiremit islands group	 Turkey
Cayman Brac	 Cayman Islands	 United Kingdom
Cebu	Visayas	 Philippines
Cedar	St. Lawrence River,  Ontario	 Canada
Cedar	Willamette River,  Oregon	 United States
Cedros	Pacific Ocean,  Baja California	 Mexico
Central Coronado	Coronado Islands,  Baja California	 Mexico
Center	San Juan Islands,  Washington	 United States
Centre	Georgian Bay,  Ontario	 Canada
Cerf	Seychelles	 Seychelles
Cessions Towhead	Mississippi River,  Arkansas	 United States
Cezi	Zhoushan Archipelago	 China
Chafarinas	Plazas de Soberanía, Strait of Gibraltar	 Spain
Champlain	Georgian Bay,  Ontario	 Canada
Champlain Monument	Georgian Bay,  Ontario	 Canada
Chandeleur	 Louisiana	 United States
Chandra	Bajuni Islands	 Somalia
Ko Chang	Gulf of Thailand	 Thailand
Changbai	Zhoushan Archipelago	 China
Change	 Newfoundland and Labrador	 Canada
Changzhi	Zhoushan Archipelago	 China
Chantry	Lake Huron,  Ontario	 Canada
Charles	 Nunavut	 Canada
Charles	 Connecticut	 United States
Charlton	 Nunavut	 Canada
Chases	Lake Winnipesaukee,  New Hampshire	 United States
Chausey	Channel Islands	 France
Cheduba		 Myanmar
Chek Lap Kok	 Hong Kong	 China
Chełminek	Oder Lagoon islands	 Poland
Chelat	Lakshadweep	 India
Chergui	Kerkenna Islands	 Tunisia
Cheung Chau	Islands District,  Hong Kong	 China
Chick	Lake Erie,  Ontario	 Canada
Chicot	 Louisiana	 United States
Chief's	Lake Joseph,  Ontario	 Canada
Chiefs	Lake Couchiching,  Ontario	 Canada
Chillicothe	Illinois River,  Illinois	 United States
Chiloane		 Mozambique
Chiloé	Chiloé Archipelago	 Chile
Isla Chincha Centro	Chincha Islands	 Peru
Isla Chincha Norte	Chincha Islands	 Peru
Isla Chincha Sur	Chincha Islands	 Peru
Chios	Aegean Islands	 Greece
Chira	Gulf of Nicoya	 Costa Rica
Chirinkotan	Kuril Islands  Sakhalin Oblast	 Russia
Chirpoy	Kuril Islands  Sakhalin Oblast	 Russia
Chizumulu	Lake Malawi	 Malawi
Choctaw Island No. 78	Mississippi River,  Arkansas	 United States
Choiseul	Melanesia	 Solomon Islands
Choupique	 Louisiana	 United States
Chouteau	Mississippi River,  Illinois	 United States
Chovaye	Bajuni Islands	 Somalia
Chowra	Central group of the Nicobar Islands	 India
Christian	Georgian Bay,  Ontario	 Canada
Christmas 	Indian Ocean	Self-governing Territory of  Australia
Chrysi		 Greece
Cula	Bajuni Islands	 Somalia
Churchill	Georgian Bay, Ontario	 Canada
Cicia	Lau Islands of Fiji	 Fiji
Čiovo		 Croatia
Île de la Cité	Seine River, Paris	 France
City	Halifax River,  Florida	 United States
City	 Florida	 United States
City	Mississippi River,  Iowa	 United States
City	The Bronx,  New York	 United States
City	Susquehanna River,  Pennsylvania	 United States
Clackamette	Willamette River,  Oregon	 United States
Clare	Clew Bay islands	 Ireland
Clarence	South Shetland Islands	Claimed by Argentine Antarctica,  Argentina,
 Antártica Chilena Province of  Chile,
and the  British Antarctic Territory of the United Kingdom
Isla Clarión	Revillagigedo Islands,  Colima	 Mexico
Clarion	Allegheny River,  Pennsylvania	 United States
Clark	San Juan Islands,  Washington	 United States
Clarksville	Mississippi River,  Illinois	 United States
Clear		 Ireland
Cleenishmeen	Lower Lough Erne	 Ireland
Clipperton	Pacific Ocean	 France
Clooney	 Louisiana	 United States
Cloquet	Mississippi River,  Minnesota	 United States
Club	Georgian Bay,  Ontario	 Canada
Club	St. Lawrence River,  Ontario	 Canada
Coats	 Nunavut	 Canada
Cobra	Algarve islands	 Portugal
Coburg	 Nunavut	 Canada
Cockburn	Lake Huron,  Ontario	 Canada
Cayo Coco	Greater Antilles	 Cuba
Coco	Algarve islands	 Portugal
Cocos	Pacific Ocean	 Costa Rica
Cocos	 Guam	 United States
Cod	 Newfoundland and Labrador	 Canada
Coelleira	 Galicia	 Spain
Coëtivy	Seychelles	 Seychelles
Cogley	Allegheny River,  Pennsylvania	 United States
Coiba	Veraguas	 Panama
Coleman	Mississippi River,  Illinois	 United States
Coll	Inner Hebrides	 United Kingdom, Scotland
Collanmore	Clew Bay islands	 Ireland
Colonsay	Inner Hebrides	 United Kingdom, Scotland
Comfort	 Louisiana	 United States
Comino	Kemmuna, Maltese Islands	 Malta
Cominotto	Maltese Islands	 Malta
Conanicut	Narragansett Bay,  Rhode Island	 United States
Conception	Seychelles	 Seychelles
Conejera	 Balearic Islands	 Spain
Conejo	Gulf of Fonseca	 Honduras
Constance	St. Lawrence River,  Ontario	 Canada
Isla Contadora	Pearl Islands	 Panama
Cook		 Cook Islands(self-governing in free association with New Zealand)
Coon	Mississippi River,  Illinois	 United States
Coon	 Louisiana	 United States
Copinsay	 Orkney Islands	 United Kingdom, Scotland
Coquet	 England	 United Kingdom
Coreille	Ottawa River,  Ontario	 Canada
Corfu	Ionian Islands	 Greece
Corisco	Rio Muni estuary	 Equatorial Guinea
Corn Holm	 Orkney Islands	 United Kingdom, Scotland
Cornwall	 Nunavut	 Canada
Cornwall	St. Lawrence River,  Ontario	 Canada
Cornwallis	 Nunavut	 Canada
Cornwallis	South Shetland Islands	Claimed by Argentine Antarctica,  Argentina,
 Antártica Chilena Province of  Chile,
and the  British Antarctic Territory of the United Kingdom
Coron		 Philippines
Coronation	South Orkney Islands	Claimed by the  United Kingdom
as part of the  Falkland Islands
and by  Argentina
Corratistune	Upper Lough Erne	 Ireland
Corregidor	Manila Bay	 Philippines
Corsica 		 France
Cortes	Discovery Islands,  British Columbia	 Canada
Corvo	 Azores	 Portugal
Cosmoledo	Outer Islands of the Seychelles	 Seychelles
Cotnam	Ottawa River,  Ontario	 Canada
Cottel	 Newfoundland and Labrador	 Canada
Cottonwood Bar	Mississippi River,  Louisiana	 United States
Couba	Mississippi River,  Louisiana	 United States
Coughran's	Lower Lough Erne	 Ireland
Courson	Allegheny River,  Pennsylvania	 United States
Cousin	Seychelles	 Seychelles
Cousine	Seychelles	 Seychelles
Cove	Lake Huron,  Ontario	 Canada
Cove	Lake Winnipesaukee,  New Hampshire	 United States
Cow	Rice Lake,  Ontario	 Canada
Cow	Lake Winnipesaukee,  New Hampshire	 United States
Cox	 British Columbia	 Canada
Cozumel	Caribbean	 Mexico
Cracroft	 British Columbia	 Canada
Cranberry	Lake Huron,  Ontario	 Canada
Crane	San Juan Islands,  Washington	 United States
Crawford	Georgian Bay,  Ontario	 Canada
Credit	Mississippi River,  Iowa	 United States
Cres	Adriatic Sea	 Croatia
Crescent	Bay of Isles, South Georgia	British overseas territory
Crescent	Georgian Bay,  Ontario	 Canada
Crete		 Greece
Crevinishaughy	Lower Lough Erne	 Ireland
Crim Rocks	Isles of Scilly	 United Kingdom
Crooked	 Florida	 United States
Crosier	Charleston Lake,  Ontario	 Canada
Crowlin	Inner Hebrides	 United Kingdom, Scotland
Crown	Lake Muskoka,  Ontario	 Canada
Crown Prince Frederik	 Nunavut	 Canada
Crozier	Kennedy Channel,  Greenland	 Denmark
Cruls	(also known as Crulls Islands)	Wilhelm Archipelago	Antarctica
Crull's	Allegheny River,  Pennsylvania	 United States
Crump Island	Lesser Antilles	 Antigua and Barbuda
Cruninish	Lower Lough Erne	 Ireland
Cseke-sziget	Danube River	 Hungary
Csepel-sziget	Danube River	 Hungary
Cuba	Greater Antilles	 Cuba
Culatra	Algarve islands	 Portugal
Culebra	Causeway Islands, Panama Canal	 Panama
Culebrita	Culebra archipelago,  Puerto Rico	 United States
Cumberland	Ohio River,  Kentucky	 United States
Cunda	Aegean Sea	 Turkey
Curaçao 	Lesser Antilles	 Kingdom of the Netherlands
Curieuse	Seychelles	 Seychelles
Cuttyhunk	Elizabeth Islands,  Massachusetts	 United States
Île aux Cygnes	Seine River, Paris	 France
Cypress	San Juan Islands,  Washington	 United States
Cyprus	Cyprus	 Cyprus and Akrotiri and Dhekelia,  United Kingdom sovereign base areas. ( Northern Cyprus claims and controls one third of the island, although this is not recognised by any country except Turkey.)
Daga	Lake Tana	 Ethiopia
Dahlak Kebir	Dahlak Archipelago	 Eritrea
Daishan	Zhoushan Archipelago	 China
Dakhin Shahbazpur	Meghna River estuary	 Bangladesh
Daksa	Elaphiti Islands	 Croatia
Dalkey	Dún Laoghaire Harbor	 Ireland
Dalma	Persian Gulf	 United Arab Emirates
Dalzel	Leeward Islands	 Saint Kitts and Nevis
Damsay	The North Isles,  Orkney	 Scotland
Dänholm	Strelasund,  Mecklenburg-Vorpommern	 Germany
Danna	Inner Hebrides	 Scotland
Dara	Persian Gulf	 Iran
Darakasi	Bajuni Islands	 Somalia
Darch	North Channel,  Ontario	 Canada
Dardenne	Mississippi River,  Missouri	 United States
Dardenne	Missouri River,  Missouri	 United States
Darrow Bar	Willamette River,  Oregon	 United States
Dassen	Atlantic Ocean	 South Africa
Dauphin	 Alabama	 United States
Davaar	Islands of the Clyde	 Scotland
Davis	Thimble Islands,  Connecticut	 United States
Davis	Hillsborough River,  Florida	 United States
Davis	Ohio River,  Pennsylvania	 United States
Dawson Island	 Antártica Chilena Province	 Chile
De la Valle	Timbalier Bay,  Louisiana	 United States
Dead	Georgian Bay,  Ontario	 Canada
Deadman	 Louisiana	 United States
Deadman's Cay	Leeward Islands in the Lesser Antilles	 Anguilla
Deans	Whitefish Lake,  Ontario	 Canada
Deasker	Monach Islands	 Scotland
Debre Sina	Lake Zway	 Ethiopia
Decatur	San Juan Islands,  Washington	 United States
Deer	Gloucester Pool,  Ontario	 Canada
Deer	 Louisiana	 United States
Deer	 Mississippi	 United States
Dehalak Deset	Dahlak Archipelago	 Eritrea
Dek	Lake Tana	 Ethiopia
Delos	Cyclades	 Greece
Denman	Gulf Islands,  British Columbia	 Canada
Denmark	Mississippi River,  Illinois	 United States
Dennery	Leeward Islands	 Saint Lucia
Dennison	Kawagama Lake,  Ontario	 Canada
Isle Dernieres	Lake Pelto, Louisiana	 United States
Dernish	Upper Lough Erne	 Ireland
Derryinch	Lower Lough Erne	 Ireland
Des Bateaux	Leeward Islands	 Saint Lucia
Deserta Grande	Madeira Islands	 Portugal
La Désirade	 Guadeloupe, Lesser Antilles	 France
Devenish	Lower Lough Erne	 Ireland
Devil	Lake Huron,  Ontario	 Canada
Devon	Queen Elizabeth Islands,  Nunavut	 Canada
Dexterity	 Nunavut	 Canada
Dharmadam	Kerala	 India
Dhuladhiya	Dahlak Archipelago	 Eritrea
Dia	Crete	 Greece
Diamond	Illinois River,  Illinois	 United States
Diamond	Ohio River,  Kentucky	 United States
Diamond	Lake Winnipesaukee,  New Hampshire	 United States
Diamond	Grenadines	 Grenada
Diamond Rock	 Martinique in the Lesser Antilles	 France
Dickinson	Tennessee River,  Tennessee	 United States
Dike	Grenadines in the Windward Islands	 Saint Vincent and the Grenadines
Dillon	Mississippi River,  Illinois	 United States
Dinas	Pembrokeshire	 Wales
Dissei	Dahlak Archipelago	 Eritrea
Diu	Daman and Diu	 India
Djerba	Gulf of Gabes	 Tunisia
Dodan	Leeward Islands	 Saint Kitts and Nevis
Dog	Gulf of Mexico,  Florida	 United States
Dog	Leeward Islands in the Lesser Antilles	 Anguilla
Dohul	Dahlak Archipelago	 Eritrea
Dolphin	Greater Antilles	 Jamaica
Dolphin	Great Salt Lake,  Utah	 United States
Domariba-sziget	Danube River	 Hungary
Dominica	Lesser Antilles	 Dominica
Don Pedro	Gulf of Mexico,  Florida	 United States
Dønna	Nordland	 Norway
Donoussa	Cyclades	 Greece
Donsö	Southern Gothenburg Archipelago	 Sweden
Dordrecht	Island part of the Dutch province South Holland	 Netherlands
Douglas	Fraser River,  British Columbia	 Canada
Dove Cay	Grenadines in the Windward Islands	 Saint Vincent and the Grenadines
Dove	Grenadines in the Windward Islands	 Saint Vincent and the Grenadines
Dow	Lake Winnipesaukee,  New Hampshire	 United States
Dowager	 British Columbia	 Canada
Dragonera island of dragons	 Balearic Islands	 Spain
Drejø	Islands south of Funen	 Denmark
Drenec	Glénan islands	 France
Dresser	Mississippi River,  Missouri	 United States
Drews	 Louisiana	 United States
Drvenik Mali	Adriatic Sea	 Croatia
Drvenik Veliki	Adriatic Sea	 Croatia
Dubh Artach	Inner Hebrides	 Scotland
Ducie	 Pitcairn Islands	 British overseas territories
Duck	Lake Huron,  Ontario	 Canada
Duds	Lake Winnipesaukee,  New Hampshire	 United States
Dugi otok	Adriatic Sea	 Croatia
Duke of York	Duke of York Islands	 Papua New Guinea
Dulcina	Leeward Islands	 Antigua and Barbuda
Dulcina	Leeward Islands	 Saint Kitts and Nevis
Dùn	St. Kilda archipelago	 Scotland
Dún Channuill	Garvellachs group in the Inner Hebrides	 Scotland
Dunasziget	Danube River	 Hungary
Dundas	 British Columbia	 Canada
Dunn	Mississippi River,  Minnesota	 United States
Dupre	 Martinique in the Lesser Antilles	 France
Durnam	Mississippi River,  Minnesota	 United States
Dursey	Beara Peninsula, County Cork	 Ireland
Duvernette	Grenadines in the Windward Islands	 Saint Vincent and the Grenadines
Eagle	 Washington	 United States
Eagle	Apostle Islands,  Wisconsin	 United States
Eagle Nest	 Alabama	 United States
Earnheart	 Arkansas	 United States
Easdale	Slate Islands	 Scotland
East Brother	The Brothers,  Hong Kong	 China
East Caicos	Bahamas,  Turks and Caicos Islands	 United Kingdom
East Cay	Leeward Islands in the Lesser Antilles,  Anguilla	 United Kingdom
East Cay	Leeward Islands in the Lesser Antilles	 Saint Kitts and Nevis
East Cay	Bahamas,  Turks and Caicos Islands	 United Kingdom
East Falkland	 Falkland Islands	 United Kingdom
East Hardwood	Lake Nipissing,  Ontario	 Canada
East	 Western Australia	 Australia
East	 Western Australia	 Australia
East		 Australia
East		 New Zealand
East	 Rhode Island	 United States
East Linga	 Shetland Islands	 Scotland
East Okak	 Newfoundland and Labrador	 Canada
East Seal Dog	 British Virgin Islands	 United Kingdom
East Sister	Lake Erie,  Ontario	 Canada
East Redonda	Strait of Georgia,  British Columbia	 Canada
East Rous	North Channel,  Ontario	 Canada
East Ship	 Mississippi	 United States
East Timbalier	Timbalier Bay, Louisiana	 United States
Easter 	called Rapa Nui in Rapa Nui	 Chile
Eastern	North Channel,  Ontario	 Canada
Ilet A Eau	Lesser Antilles,  Martinique	 France
Ebeye	Ralik Chain	 Marshall Islands
Ebon Atoll	Ralik Chain	 Marshall Islands
Echo	Georgian Bay,  Ontario	 Canada
Eclipse	Great Palm Island group,  Queensland	 Australia
Eday	 Orkney Islands	 Scotland
Eden	 Arkansas	 United States
Egdell	 Nunavut	 Canada
Edgeøya	Svalbard	 Norway
Estido	 South Carolina	 United States
Edith Hammock	 Alabama	 United States
Éfaté	Pacific Ocean	 Vanuatu
Egg Island	Great Salt Lake	 United States
Egg	Bahamas	 Bahamas
Egg	North Channel,  Ontario	 Canada
Egholm	Limfjord	 Denmark
Egilsay	The North Isles,  Orkney Islands	 Scotland
Eglington	Queen Elizabeth Islands,  Northwest Territories	 Canada
Eigg	Inner Hebrides	 Scotland
Eighteen Mile	French River,  Ontario	 Canada
Eightmile	 West Virginia	 United States
Eilean Buidhe	Burnt Islands	 Scotland
Eilean Dubh	Kyles of Bute	 Scotland
Eilean Dubh	Summer Isles	 Scotland
Eilean Dubh	Sound of Jura	 Scotland
Eilean Dubh	Loch Craignish	 Scotland
Eilean Dubh	Balnakeil Bay	 Scotland
Eilean Dubh	Loch Shiel	 Scotland
Eilean Dubh a' Chumhainn Mhòir	Loch Tarbert	 Scotland
Eilean Dubh Mòr	Inner Hebrides	 Scotland
Eilean Dearg	Islands of the Clyde	 Scotland
Eilean Fraoich	Burnt Islands	 Scotland
Eilean Gowan	Lake Muskoka,  Ontario	 Canada
Eilean Mòr	Burnt Islands	 Scotland
Ekerö och Munsö		 Sweden
Ekinlik	Sea of Marmara	 Turkey
El Hierro	 Canary Islands	 Spain
Elafonissos		 Greece
Elba	Tuscan Archipelago	 Italy
Elbow Cay	Bahamas	 Bahamas
Elephant	Jason Islands of the  Falkland Islands	British Overseas Territory of the  United Kingdom
Elephant	South Shetland Islands	Claimed by Argentine Antarctica,  Argentina,  Antártica Chilena Province of  Chile, and  British Antarctic Territory of the  United Kingdom
Elephanta	Maharashtra	 India
Eleuthera	Bahamas	 Bahamas
Eliot	 Alabama	 United States
Eliza	San Juan Islands,  Washington	 United States
Elizabeth	Bahamas	 Bahamas
Elizabeth	 Bermuda	 United Kingdom
Elizabeth	Georgian Bay (Parry Sound),  Ontario	 Canada
Elizabeth	Lake Superior,  Michigan	 United States
Elizabeth	Western Port Bay,  Victoria	 Australia
Elk	 Wyoming	 United States
Ellef Ringnes	Sverdrup Islands,  Nunavut	 Canada
Ellesmere	 Nunavut	 Canada
Ellis	New York Harbor, New York	 United States
Elm	 Maryland/ Virginia	 United States
Elm	North Channel,  Ontario	 Canada
Elm	Montgomery County, Maryland near Blockhouse Point	 United States
Elmtree	Georgian Bay,  Ontario	 Canada
Eloaua	St. Matthias Islands	 Papua New Guinea
Elobey Grande	Río Muni	 Equatorial Guinea
Elobey Chico	Río Muni	 Equatorial Guinea
Eluvai Theevu		 Sri Lanka
Émaé	Shepherd Islands	 Vanuatu
Émao	Shepherd Islands	 Vanuatu
Emerald	Greater Antilles	 Jamaica
Emerald	Queen Elizabeth Islands,  Northwest Territories	 Canada
Emerald	Buckhorn Lake,  Ontario	 Canada
Emirau	St. Matthias Islands	 Papua New Guinea
Enchanted	Mississippi River,  Iowa	 United States
Endelave	Kattegat	 Denmark
Endicott	Beaufort Sea,  Alaska	 United States
Endymion	St. Lawrence River,  Ontario	 Canada
Enewetak	Ralik chain	 Marshall Islands
Cayo Enrique	Greater Antilles,  Puerto Rico	 United States
Enterprise Island	Mississippi River,  Illinois	 United States
Epi	Pacific Ocean	 Vanuatu
Epsilon	 Bermuda	 United Kingdom
Ereikoussa		 Greece
Erikub Atoll	Ralik Chain	 Marshall Islands
Isla del Erio	Greater Antilles,  Puerto Rico	 United States
Ermal	Minho Islands	 Portugal
Erraid	Inner Hebrides	 Scotland
Erromango	Pacific Ocean	 Vanuatu
Ertholmene	also known as Christiansø	 Denmark
Ertvågøy		 Norway
Erwa	Dahlak Archipelago	 Eritrea
Esk	Great Palm Island group,  Queensland	 Australia
Isla del Espiritu Santo	 Baja California Sur	 Mexico
Espiritu Santo	Pacific Ocean	 Vanuatu
Cayo Esquivel	Greater Antilles	 Cuba
Esslinger	 Alabama	 United States
Estrada	Beira Baixa Islands	 Portugal
Eta	 Bermuda	 United Kingdom
Etolin	Alexander Archipelago,  Alaska	 United States
Euboea	Greek archipelago	 Greece
Eustatia	 British Virgin Islands	 United Kingdom
Eureka	Ohio River,  West Virginia	 United States
Evans	Prince William Sound,  Alaska	 United States
Evans	 Nevada	 United States
Evelyn	 Western Australia	 Australia
Evelyn	Lake Huron,  Ontario	 Canada
Evergreen	Lake Winnipesaukee,  New Hampshire	 United States
Exchange	Leeward Islands in the Lesser Antilles	 Antigua and Barbuda
Exuma	Bahamas	 Bahamas
Eynhallow	The North Isles,  Orkney Islands	 Scotland
Eysturoy	 Faroe Islands	 Denmark
Fænø	Islands of the Little Belt	 Denmark
Fabiacet (Fabiajet)	Raja Ampat Islands	 Indonesia
Faial	 Azores	 Portugal
Failaka	Persian Gulf	 Kuwait
Fairbank	Fairbank Lake,  Ontario	 Canada
Fairly Lake	Stoney Lake,  Ontario	 Canada
Fahie	Leeward Islands	 Saint Kitts and Nevis
Fakarava	Palliser Islands,  Tuamotus,  French Polynesia	 France
Fallen Jerusalem	 British Virgin Islands	 United Kingdom
False Duck	Lake Ontario,  Ontario	 Canada
False Plum Pudding		 Namibia
Falster		 Denmark
Fancy Point Towhead	Mississippi River,  Louisiana	 United States
Fangataufa	 Tuamotus,  French Polynesia	 France
Fanny	North Channel,  Ontario	 Canada
Fanø	North Frisian Islands	 Denmark
Fara	The South Isles,  Orkney Islands	 Scotland
Farasan	Farasan Islands	 Saudi Arabia
Faray	The North Isles,  Orkney Islands	 Scotland
Farkas-sziget	Tisza	 Hungary
Faro	Algarve islands	 Portugal
Fårö	Gotland	 Sweden
Farsi	Persian Gulf	 Iran
Fastnet Rock	County Cork	 Ireland
Fatuma		 Eritrea
Fauro	Shortland Islands	 Solomon Islands
Favignana	Aegadian Islands	 Italy
Fawn	St. Clair River,  Ontario	 Canada
Fehmarn		 Germany
Fejø		 Denmark
Félicité	Inner Islands of the Seychelles	 Seychelles
Felsőzátonyi-sziget	Danube River	 Hungary
Femø		 Denmark
Fernando de Noronha		 Brazil
Fern Island	 Bermuda	 United Kingdom
Ferny	Lower Lough Erne	 Ireland
Fetlar	 Shetland Islands	 Scotland
Fiat	Spratley Islands	Disputed between  People's Republic of China,  Republic of China,  Vietnam,  Brunei,  Philippines, and  Malaysia
Fidra	Islands of the Forth	 Scotland
Fifi	Barataria Bay,  Louisiana	 United States
Fighting	Detroit River,  Ontario	 Canada
Filfla	Maltese islands	 Malta
Finnøy	Ryfylke Islands, Rogaland	 Norway
Fish Holm	 Shetland Islands	 Scotland
Fish	Matanzas River,  Florida	 United States
Fish	Lake Winnipesaukee,  New Hampshire	 United States
Fisherman	Chesapeake Bay,  Virginia	 United States
Fitzwilliam	Lake Huron,  Ontario	 Canada
Five	Leeward Islands	 Antigua and Barbuda
Five	North Channel,  Ontario	 Canada
Five	Willamette River,  Oregon	 United States
Five Star	 Bermuda	 United Kingdom
Fivemile	Lake Winnipesaukee,  New Hampshire	 United States
Finnhamn	Stockholm archipelago	 Sweden
Fjandø	Islands of Nissum Fjord	 Denmark
Flaherty	Belcher Islands,  Nunavut	 Canada
Flakstadøya	Lofoten	 Norway
Flanigan	Mississippi River,  Illinois	 United States
Flat	Jason Islands of the  Falkland Islands	 United Kingdom
Flat Holm	Bristol Channel	 United Kingdom
Flattop	San Juan Islands,  Washington	 United States
Flekkerøy		 Norway
Flinders	Bass Strait,  Tasmania	 Australia
Flint	Line Islands	 Kiribati
Florence	Lake Rosseau,  Ontario	 Canada
Flores	 Azores	 Portugal
Flores	Lesser Sunda Islands	 Indonesia
Flotta	The South Isles,  Orkney Islands	 Scotland
Flowerpot	Georgian Bay,  Ontario	 Canada
Fluor	Lake Superior,  Ontario	 Canada
Fodu	Zhoushan Archipelago	 People's Republic of China
Fogn	Island in Finnøy municipality, Ryfylke Islands, Rogaland	 Norway
Fogo	 Newfoundland and Labrador	 Canada
Fogo	Sotavento archipelago	 Cape Verde
Föhr	North Frisian Islands	 Germany
Folegandros	Cyclades	 Greece
Foley	 Nunavut	 Canada
Fora	Estremadura islands	 Portugal
Forked Deer	Mississippi River,  Tennessee and  Arkansas	 United States
Formentera	Illes Pitiüses group of the  Balearic Islands	 Spain
Formoza	Artificial island at Gdynia	 Poland
Fornation	Timbalier Bay,  Louisiana	 United States
Forur Bozorg	Persian Gulf	 Iran
Forur Koochak	Persian Gulf	 Iran
Forurgan	Persian Gulf	 Iran
Foster	Georgian Bay,  Ontario	 Canada
Fota	The Grenadines in the Windward Islands	 Grenada
Fota	Cork Harbour	 Ireland
Foula	 Shetland Islands	 Scotland
Fourer	Lesser Antilles	 Saint Lucia
Fourmile	French River,  Ontario	 Canada
Fournoi		 Greece
Fourteen Mile	Allegheny River,  Pennsylvania	 United States
Fous	Lesser Antilles	 Saint Lucia
Fox	Buckhorn Lake  Ontario	 Canada
Fox	Georgian Bay,  Ontario	 Canada
Fox	Lake Simcoe,  Ontario	 Canada
Frøya	Sør-Trøndelag	 Norway
Franklin	 Greenland	 Denmark
Franklin	Georgian Bay,  Ontario	 Canada
Freixial	Alentejo islands	 Portugal
Fremont	Great Salt Lake,  Utah	 United States
French Cay	Greater Antilles	 Dominican Republic
French	Western Port	 Australia
French	Mississippi River,  Wisconsin	 United States
French Island No. 1	Ohio River,  Kentucky	 United States
French Island No. 2	Ohio River,  Kentucky	 United States
French River	Georgian Bay,  Ontario	 Canada
Frenchmans Cay	 British Virgin Islands	 United Kingdom
Friars	Leeward Islands	 Saint Kitts and Nevis
Frégate	Lesser Antilles	 Saint Lucia
Frigate	The Grenadines in the Windward Islands	 Grenada
Frigate	The Grenadines in the Windward Islands	 Saint Vincent and the Grenadines
Fritz	Schuylkill River,  Pennsylvania	 United States
Frösön		 Sweden
Fryingpan	Georgian Bay,  Ontario	 Canada
Fuerteventura	 Canary Islands	 Spain
Fugloy	 Faroe Islands	 Denmark
Funen		 Denmark
Funk	 Newfoundland and Labrador	 Canada
Fur	Islands of Limfjord	 Denmark
Futuna	Pacific Ocean	 Vanuatu
Gabaret	Mississippi River,  Illinois	 United States
Gabriola	Gulf Islands,  British Columbia	 Canada
Gaga	Beira Litoral Islands	 Portugal
Gaivota	Beira Litoral Islands	 Portugal
Gairsay	The North Isles,  Orkney Islands	 Scotland
Galiano	Gulf Islands,  British Columbia	 Canada
Galila	Lake Zway	 Ethiopia
Gall	Lough Erne	 Ireland
Gallinara		 Italy
Galt	North Channel,  Ontario	 Canada
Galveston	 Texas	 United States
Gansy	Lake Winnipesaukee,  New Hampshire	 United States
Gapøya		 Norway
Garden	Lake Huron,  Ontario	 Canada
Garden	Lake Nipissing,  Ontario	 Canada
Garden	Saint Lawrence River,  Ontario	 Canada
Garden	 Western Australia	 Australia
Gardner	 Louisiana	 United States
Garove	Vitu Islands	 Papua New Guinea
Garratt	West Lake  Ontario	 Canada
Gasket	West Lake  Ontario	 Canada
Gateshead	 Nunavut	 Canada
Gaua	Banks Islands	 Vanuatu
Gavi	Pontine Islands	 Italy
Gavdos		 Greece
Geada	Algarve Islands	 Portugal
Geike	Lake Nipigon,  Ontario	 Canada
Gelila Zakarias	Lake Tana	 Ethiopia
Genovesa	Galápagos Islands	 Ecuador
Geomundo		 South Korea
George	 Falkland Islands	 United Kingdom
George	Georgian Bay,  Ontario	 Canada
Georgetown	Ohio River,  Pennsylvania	 United States
Georgina	Lake Simcoe,  Ontario	 Canada
Germ	Persian Gulf	 Iran
Geronisos		 Cyprus
Gertrude	North Channel,  Ontario	 Canada
Gerumajima	Kerama Islands part of the Okinawa Islands part of the Ryukyu Islands	 Japan
Gęsia Kępa	Oder Lagoon islands	 Poland
Ghegheto	Lake Huron,  Ontario	 Canada
Giannutri	 Tuscan Archipelago	 Italy
Giants Tomb	Georgian Bay,  Ontario	 Canada
Gibbs	South Shetland Islands	Claimed by:
Argentine Antarctica,  Argentina,
 Antártica Chilena Province of  Chile, and
 British Antarctic Territory of the United Kingdom
Gidicho	Lake Abaya	 Ethiopia
Gigha	Inner Hebrides	 Scotland
Giglio	 Tuscan Archipelago	 Italy
Gil	 British Columbia	 Canada
Gilbert	Mississippi River,  Missouri	 United States
Gilford	 British Columbia	 Canada
Gimsøya	Lofoten	 Norway
Gioura	Sporades	 Greece
Giudecca	 Venetian Lagoon	 Italy
Giske		 Norway
Gisløy		 Norway
Glims Holm	 Orkney Islands	 Scotland
Glines	Lake Winnipesaukee,  New Hampshire	 United States
Gloup Holm	 Shetland Islands	 Scotland
Glykiotissa		 Cyprus
Goat	Lough Erne	 Ireland
Goat	Whitsunday Islands,  Queensland	 Australia
Goat	Sydney Harbor	 Australia
Goat	Auckland Region	 New Zealand
Goat	Otago Harbour	 New Zealand
Goat	Niagara Falls  New York	 United States
Goat	 Rhode Island	 United States
Goat	 Maine	 United States
Goat	North Channel,  Ontario	 Canada
Goat	 South Carolina	 United States
Gödi-sziget		 Hungary
Godøy		 Norway
Goeree-Overflakkee	part of the Dutch province South Holland	 Netherlands
Gokceada	Aegean Islands	 Turkey
Golem Grad	Lake Prespa	 Macedonia
Goli otok	translates as "naked island"	 Croatia
La Gomera	 Canary Islands	 Spain
Goodin	Mississippi River, Minnesota	 United States
Goose Island	Great Salt Lake,  Utah	 United States
Goose	Lake Nipissing,  Ontario	 Canada
Goose	 British Columbia	 Canada
Goose	San Juan Islands,  Washington	 United States
Gooseberry	North Channel,  Ontario	 Canada
Gorée	Dakar	 Senegal
Gorgona		 Colombia
Gorgona	 Tuscan Archipelago	 Italy
Gossa		 Norway
Gotland		 Sweden
Gotska Sandön		 Sweden
Gough	 Tristan da Cunha	 British overseas territory of  Saint Helena, Ascension and Tristan da Cunha
Governor	Thimble Islands,  Connecticut	 United States
Governor	Georgian Bay,  Ontario	 Canada
Governors	Lake Winnipesaukee,  New Hampshire	 United States
Gower	Cumberland River,  Tennessee	 United States
Gozo	Għawdex, Maltese islands	 Malta
Graciosa	 Azores	 Portugal
Graciosa	 Canary Islands	 Spain
Graemsay	 Orkney Islands	 Scotland
Graham	Queen Elizabeth Islands,  Nunavut	 Canada
Graham	Queen Charlotte Islands,  British Columbia	 Canada
Gramatal Island	Beira Litoral Islands	 Portugal
Gran Canaria	 Canary Islands	 Spain
Granary	Islands of Gdańsk	 Poland
Grand Cayman	 Cayman Islands	 United Kingdom
Grand	Jason Islands of the  Falkland Islands	 United Kingdom
Grand	Balsam Lake,  Ontario	 Canada
Grand	 Louisiana	 United States
Grand	 Louisiana	 United States
Grand	Lake Champlain,  Vermont	 United States
Grand Manan	 New Brunswick	 Canada
Grand Terre	 Louisiana	 United States
Grande Comore	Comoros	 Comoros
Grande-Terre	 Guadeloupe, Lesser Antilles	 France
Grape	Lake Simcoe,  Ontario	 Canada
Gräsö		 Sweden
Gravelly	Lough Erne	 Ireland
Gravine	Mobile Bay,  Alabama	 United States
Gray	Georgian Bay,  Ontario	 Canada
Great Blasket	Blasket Islands	 Ireland
Great Britain		 United Kingdom
Great	 Falkland Islands	 United Kingdom
Great	Cork Harbour	 Ireland
Great	 Massachusetts	 United States
Great La Cloche	North Channel,  Ontario	 Canada
Great Manitou	Lake Nipissing,  Ontario	 Canada
Great Nicobar	Nicobar Islands	 India
Greater Mount Changtu	Zhoushan Archipelago	 China
Greater Mount Yang	Zhoushan Archipelago	 China
Greater Tunbs	Persian Gulf	 Iran
Green	 Queensland	 Australia
Green	 New South Wales	 Australia
Green	 Jersey, Channel Islands	 Crown dependency
Green	Isles of Scilly	 United Kingdom
Green	Poole Harbour	 United Kingdom
Green	Rideau River,  Ontario	 Canada
Green	Severn Sound,  Ontario	 Canada
Greene	Ottawa River,  Ontario	 Canada
Green	 Hong Kong	 China
Green	Taitung County	 Republic of China
Green	Red Sea	 Egypt
Greene	Lake Huron,  Ontario	 Canada
Greene	Lake Ontario,  Ontario	 Canada
Greenisland	Northern Ireland	 United Kingdom
Greenland 		 Denmark
Greenspond	 Newfoundland and Labrador	 Canada
Greenwich	South Shetland Islands	Claimed by:
Argentine Antarctica, Argentina,
 Antártica Chilena Province of  Chile, and
 British Antarctic Territory of the United Kingdom
Grenadier	Thousand Islands  New York	 United States
Grenadier	Saint Lawrence River  Ontario	 Canada
Greifswalder Oie		 Germany
Grgur		 Croatia
Gribbell	 British Columbia	 Canada
Griffith	Queen Elizabeth Islands,  Nunavut	 Canada
Griffith	Windmill Islands	Antarctica
Griffith	Georgian Bay,  Ontario	 Canada
Grimes	Mississippi River,  Illinois	 United States
Grímsey		 Iceland
Grindstone	Thousand Islands (Saint Lawrence River),  New York	 United States
Grindstone	Big Rideau Lake,  Ontario	 Canada
Grip		 Norway
Gris Bourbe	 Louisiana	 United States
Grisvågøy		 Norway
Gröde-Appelland	North Frisian Islands	 Germany
Groix	Morbihan,  Bretagne	 France
Grøtøy		 Norway
Grunay	Out Skerries,  Shetland Islands	 Scotland
Gruney	 Shetland Islands	 Scotland
Grytøy	Vesterålen	 Norway
Guam		 United States
Guana Key	Island Territory of Sint Maarten,  Netherlands Antilles	 Kingdom of the Netherlands
Guemes	San Juan Islands,  Washington	 United States
Guernsey	 Guernsey, Channel Islands	 Crown dependency
Gull	Lake Nipissing,  Ontario	 Canada
Gull	Lake Ontario,  Ontario	 Canada
Gull	Lake Mead,  Nevada	 United States
Gunnison	Great Salt Lake,  Utah	 United States
Gurskøy		 Norway
Gyali	Dodecanese	 Greece
Gyaros	Cyclades	 Greece
Haaf Gruney	 Shetland Islands	 Scotland
Hadseløya	Vesterålen	 Norway
Hailuoto		 Finland
Hainan		 China
Hajógyári-sziget	Danube River	 Hungary
Halfmoon	Georgian Bay  Ontario	 Canada
Half Moon	South Shetland Islands	Claimed by Argentine Antarctica,  Argentina,  Antártica Chilena Province of  Chile, and  British Antarctic Territory of the United Kingdom
Half Moon	 Louisiana	 United States
Halfmile	Lake Winnipesaukee,  New Hampshire	 United States
Halib		 Eritrea
Halifax		 Namibia
Halki	Dodecanese	 Greece
Hallig Habel	North Frisian Islands	 Germany
Hamburger Hallig	North Frisian Islands	 Germany
Hanerahu	Väinameri Sea	 Estonia
Hanikatsi laid	Väinameri Sea	 Estonia
Hans	Kennedy Channel of Nares Strait	Claimed by both  Denmark and  Canada
Hao	 Tuamotus,  French Polynesia	 France
Hara	Gulf of Finland	 Estonia
Harat	Dahlak Archipelago	 Eritrea
Hareidland		 Norway
Harilaid	Baltic Sea	 Estonia
Harmil	Dahlak Archipelago	 Eritrea
Harris	Rice Lake,  Ontario	 Canada
Hascosay	 Shetland Islands	 Scotland
Hatch	Georgian Bay  Ontario	 Canada
Hateruma	Yaeyama Islands part of the Sakishima Islands part of the Ryukyu Islands	 Japan
Hatoma	Yaeyama Islands part of the Sakishima Islands part of the Ryukyu Islands	 Japan
Hatteras	Outer Banks,  North Carolina	 United States
Havra	 Shetland Islands	 Scotland
Hawai‘i	 Hawaii	 United States
Hawar	Hawar Islands	 Bahrain
Hawk	 New Jersey	 United States
Hawkesbury	 British Columbia	 Canada
Hawks Nest	Lake Winnipesaukee,  New Hampshire	 United States
Hay	Georgian Bay  Ontario	 Canada
Hayden	Columbia River,  Oregon	 United States
Hecate	 British Columbia	 Canada
Hei Ling Chau	Islands District,  Hong Kong	 China
Heimaey	Vestmannaeyjar	 Iceland
Helgö	Lake Mälaren	 Sweden
Heligoland	Heligoland Bight,  Schleswig-Holstein	 Germany
Helliar Holm	 Orkney Islands	 Scotland
Helnæs	Islands of the waters south of Funen	 Denmark
Hen	Lake Erie,  Ontario	 Canada
Hen and Chicken	Georgian Bay  Ontario	 Canada
Henderson	 Pitcairn Islands	 British overseas territories
Henderson	Shackleton Ice Shelf, Antarctica	
Henderson	Ohio River,  Kentucky	 United States
Hendurabi	Persian Gulf	 Iran
Hengam	Persian Gulf	 Iran
Henry	San Juan Islands,  Washington	 United States
Isle aux Herbes	 Alabama	 United States
Hereheretue	Duke of Gloucester Islands,  Tuamotus,  French Polynesia	 France
Herm 	Channel Islands	 Guernsey
Hermit	Lake Winnipesaukee,  New Hampshire	 United States
Heron	Lake Mead,  Nevada	 United States
Herrs	Allegheny River,  Pennsylvania	 United States
Hertsön		 Sweden
Herschel	Lake Huron  Ontario	 Canada
Herschel	 Yukon	 Canada
Hertzberg	Georgian Bay  Ontario	 Canada
Hess	Susquehanna River,  Pennsylvania	 United States
Hesselø	The Kattegat	 Denmark
Hestan	Solway Firth,  Scotland	 United Kingdom
Hestur	 Faroe Islands	 Denmark
Heybeliada	Prince's Islands	 Turkey
Hickory	West Lake  Ontario	 Canada
Hiddensee	Islands of the Baltic Sea	 Germany
Hiiumaa	West Estonian archipelago; Baltic Sea	 Estonia
Wirral	estuary of the River Dee	 UK
Hildasay	 Shetland Islands	 Scotland
Hinnøya	Vesterålen	 Norway
Hisingen	Kattegat, Västergötland and Bohuslän	 Sweden
Hispaniola	Antilles	 Haiti and  Dominican Republic
Hitra	Trondheimsfjord	 Norway
Hiu	Torres Islands	 Vanuatu
Hiwassee	Chickamauga Lake,  Tennessee	 United States
Hjelm		 Denmark
Hjortø	Islands of the waters south of Funen	 Denmark
Hoak	Susquehanna River,  Pennsylvania	 United States
Hobbs	Tennessee River,  Alabama	 United States
Hobulaid	Väinameri Sea	 Estonia
Hoëdic	 Bretagne	 France
Hoeksche Waard	 South Holland	 Netherlands
Hoffman	Illinois River,  Illinois	 United States
Hog	North Channel,  Ontario	 Canada
Hog	Ottawa River,  Ontario	 Canada
Hog	Essequibo River	 Guyana
Hog	Narragansett Bay,  Rhode Island	 United States
Hog	 Wisconsin	 United States
Hog	 Michigan	 United States
Hog	James River,  Virginia	 United States
Hog	Petaluma River,  California	 United States
Hog	Tomales Bay,  California	 United States
Hog	Aleutian Islands,  Alaska	 United States
Hokkaidō	Japanese Archipelago	 Japan
Holm of Faray	The North Isles,  Orkney Islands	 Scotland
Holm of Huip	The North Isles,  Orkney Islands	 Scotland
Holm of Papay	The North Isles,  Orkney Islands	 Scotland
Holm of Scockness	The North Isles,  Orkney Islands	 Scotland
Hong Kong Island	 Hong Kong	 China
Honshū	Japanese Archipelago	 Japan
Hooge	North Frisian Islands	 Germany
Hope[disambiguation needed]	 British Columbia	 Canada
Hope	Georgian Bay,  Ontario	 Canada
Hopen	Svalbard	 Norway
Hõralaid	Väinameri Sea	 Estonia
Hormuz	Persian Gulf	 Iran
Horn	 Mississippi	 United States
Hornby	Gulf Islands, British Columbia	 Canada
Horse	Thimble Islands,  Connecticut	 United States
Horse	 Shetland Islands	 Scotland
Horse	Summer Isles	 Scotland
Horse Islands	 Newfoundland and Labrador	 Canada
Houat	 Bretagne	 France
Housay	Out Skerries,  Shetland Islands	 Scotland
Howakil	Dahlak Archipelago	 Eritrea
Howe	Saint Lawrence River  Ontario	 Canada
Howell	Missouri River, Missouri	 United States
Howland Island
Hoy	The South Isles,  Orkney Islands	 Scotland
Huahine	Windward Islands, Society Islands,  French Polynesia	Overseas collectivity of  France
Hauhine Iti	Windward Islands, Society Islands,  French Polynesia	Overseas collectivity of  France
Hauhine Nui	Windward Islands, Society Islands,  French Polynesia	Overseas collectivity of  France
Huckleberry	Georgian Bay (Parry Sound)  Ontario	 Canada
Hülgerahu	Väinaeri Sea	 Estonia
Hull	Lake Winnipesaukee,  New Hampshire	 United States
Hunda	The South Isles,  Orkney Islands	 Scotland
Hundvåg	Øyane archipelago, Stavanger municipality, Rogaland	 Norway
Huney	 Shetland Islands	 Scotland
Hurricane	Illinois River,  Illinois	 United States
Hurricane	Ohio River,  Kentucky	 United States
Hvar		 Croatia
Hven		 Sweden
Hydra	Saronic Islands	 Greece
Ibestadøya		
Ibicuy	Paraná Delta	 Argentina
Ibiza	 Balearic Islands	 Spain
Iceland		 Iceland
Ida	Torres Strait Islands,  Queensland	 Australia
Idanha	Beira Baixa islands	 Portugal
Idjwi	Lake Kivu	 Democratic Republic of the Congo
Iejima	Okinawa Islands part of the Ryukyu Islands	 Japan
Iheyajima	Okinawa Islands part of the Ryukyu Islands	 Japan
IJsselmonde	 South Holland	 Netherlands
Ikaria		 Greece
Ikema	Miyako Islands part of the Sakishima Islands part of the Ryukyu Islands	 Japan
Île d'Ouessant	English Channel	 France
Île d'Yeu	 Pays de la Loire	 France
Île-d'Aix		 France
Île-d'Arz	Gulf of Morbihan	 France
Île Des Soeurs	Bassin de Laprairie	 Canada
Île Sainte-Marguerite	Lérins Islands	 France
Îles-de-Boucherville	St. Lawrence River	 Canada
Îlot Saint-Ferréol	Lérins Islands	 France
Île Saint-Honorat	Lérins Islands	 France
Îles Sainte-Thérèse	St. Lawrence River	 Canada
Îlot de la Tradelière	Lérins Islands	 France
Îles d'Hyères	Île du Levant, Île de Porquerolles, and Île de Port-Cros	
Ilha Grande		 Brazil
Ilhas Cagarras	Guanabara Bay	 Brazil
Ilovik	Adriatic Sea	 Croatia
Inaccessible	 Tristan da Cunha	 British overseas territory of  Saint Helena, Ascension and Tristan da Cunha
Inaccessible	South Orkney Islands	Claimed by:
 the United Kingdom as part of the  Falkland Islands and by
 Argentina
Inaccessible	Dellbridge Islands	Antarctica
Indian	Rock River,  Illinois	 United States
Indian	Lake Huron,  Ontario	 Canada
Ingarö		 Sweden
Ingram	 Queensland	 Australia
Inhaca		 Mozambique
Inish Beg	Lough Erne	 Ireland
Inish Conra		 Ireland
Inish Davar		 Ireland
Inish Divann		 Ireland
Inish Doney	Lough Erne	 Ireland
Inish Fovar	Lough Erne	 Ireland
Inish Free	Lough Gill	 Ireland
Inish Lougher	Lough Erne	 Ireland
Inish More	Lough Erne	 Ireland
Inishbiggle	County Mayo	 Ireland
Inishbofin	County Donegal	 Ireland
Inishbofin	County Galway	 Ireland
Inishcorkish	Upper Lough Erne	 Ireland
Inisheer	Aran Islands	 Ireland
Inishkea North	County Galway	 Ireland
Inishkea South	County Galway	 Ireland
Inishleague	Lough Erne	 Ireland
Inishlirroo	Upper Lough Erne	 Ireland
Inishlught	Upper Lough Erne	 Ireland
Inishmaan	Aran Islands	 Ireland
Inishmacsaint	Lough Erne	 Ireland
Inishmakill	Lough Erne	 Ireland
Inishmore	Aran Islands	 Ireland
Inishmurray		 Ireland
Inishark		 Ireland
Inishturk	Lough Erne	 Ireland
Innarahu	Baltic Sea	 Estonia
Innetalling	Hudson Bay,  Nunavut	 Canada
Innisfallen	Lough Leane	 Ireland
Insua	Minho islands	 Portugal
Iona	Inner Hebrides	 Scotland
Iona	Straight of Georgia	 Canada
Iona	Placentia Bay	 Canada
Iona	Hudson River	 United States
Ios	Cyclades	 Greece
Iowa	Mississippi River,  Illinois	 United States
Irabu	Miyako Islands part of the Sakishima Islands part of the Ryukyu Islands	 Japan
Irakleia	Cyclades	 Greece
Ireland		 Ireland
Ireland's Eye	County Dublin	 Ireland
Iriomote	Yaeyama Islands part of the Sakishima Islands part of the Ryukyu Islands	 Japan
Ischia	Gulf of Naples	 Italy
Ishigaki	Yaeyama Islands part of the Sakishima Islands part of the Ryukyu Islands	 Japan
Island 526	Mississippi River,  Missouri	 United States
Island No. 8	Mississippi River,  Kentucky	 United States
Island No. 21	Mississippi River,  Tennessee	 United States
Island No. 30	Mississippi River,  Tennessee and  Arkansas	 United States
Island No. 63	Mississippi River,  Mississippi	 United States
Island No. 317	Mississippi River,  Illinois	 United States
Island of Montreal	 Quebec	 Canada
Islands of St. Paul	Maltese islands	 Malta
Islas Cíes	belonging to the Spanish province of Pontevedra, in Galicia	 Spain
Islay	Inner Hebrides	 Scotland
Isle of Man	Irish Sea	 Crown dependency
Isle of Thanet	British Isles	 United Kingdom
Isle of Wight	In Roman times was referred to as Vectis	 United Kingdom
Isle of Youth	Greater Antilles	 Cuba
Isola di San Michele	Venetian Lagoon	 Italy
Isola Maggiore	Lake Trasimeno	 Italy
Isra-Tu	Dahlak Archipelago	 Eritrea
Ist		 Croatia
Itamaracá		 Brazil
Ithaki	Ionian Islands	 Greece
Itu Aba	Spratley Islands	Administered by
 Republic of China,
Claimed by:
 China,
 Vietnam, and
 Philippines
Isla Ixtapa	Ixtapa/Zihuatanejo,  Guerrero	 Mexico
Iž		 Croatia
Izenajima	Okinawa Islands part of the Ryukyu Islands	 Japan
Jabat	Ralik Chain	 Marshall Islands
Jabwot	Ralik Chain	 Marshall Islands
Jack	Lake Huron,  Ontario	 Canada
Jack	 Washington	 United States
Jacks	Allegheny River,  Pennsylvania	 United States
Jackson	Franz Josef Land	 Russia
Jackson	Mississippi River,  Iowa	 United States
Jaluit Atoll		 Marshall Islands
Jamaica	Greater Antilles	 Jamaica
Jamestown	James River,  Virginia	 United States
Jan Mayen		 Norway
Java	Sunda Arc	 Indonesia
Jef Fam Group	Raja Ampat Islands	 Indonesia
Jegindø	The Limfjord	 Norway
Jemo		 Marshall Islands
Jersey 	Channel Islands	 Crown dependency
Jethou	Channel Islands	 Crown dependency
Jintang	Zhoushan Archipelago	 China
Joes	Lake Winnipesaukee,  New Hampshire	 United States
Johns	San Juan Islands,  Washington	 United States
Johnson	Missouri River,  Missouri	 United States
Johnson	French Broad River,  Tennessee	 United States
Jones	Missouri River,  South Dakota	 United States
Jonobi	Persian Gulf	 Iran
Juananga	Juan Fernández Islands	 Chile
Juist	East Frisian Islands	 Germany
Jura	Inner Hebrides	 Scotland
Jüri		
Juromenha	Alentejo islands	 Portugal
Jeju		 South Korea
Kachelotplate	East Frisian Islands	 Germany
Kácsa-sziget	Tisza	 Hungary
Kagalaska	Andreanof Islands group of the Aleutian Islands,  Alaska	 United States
Kahoolawe	 Hawaiian Islands	 United States
Kakawaie	Lake Kagawong,  Ontario	 Canada
Kakeromajima	Amami Islands part of the Satsunan Islands part of the Ryukyu Islands	 Japan
Kakrasaar		 Estonia
Kalamos	Ionian Islands	 Greece
Kalolimnos	Dodecanese	 Greece
Kalpeni	Lakshadweep	 India
Kalymnos	Dodecanese	 Greece
Kållandsö	Vänern lake	 Sweden
Kalsoy	 Faroe Islands	 Denmark
Kamenka	Kolyma Bay	 Russia
Kanaga	Andreanof Islands group of the Aleutian Islands,  Alaska	 United States
Kapingamarangi		 Federated States of Micronesia
Kapiti		 New Zealand
Kapussaar		 Estonia
Karaginsky	Bering Sea Group	 Russia
Karkarpko	Chukchi Sea Group	 Russia
Karmøy		 Norway
Kárpathos	Dodecanese	 Greece
Karsibór	Oder Lagoon islands	 Poland
Kásos	Dodecanese	 Greece
Kastellórizo	Dodecanese	 Greece
Kastos	Ionian Islands	 Greece
Kat O	 Hong Kong	 China
Katič	Adriatic Sea	 Montenegro
Kau Sai Chau	 Hong Kong	 China
Kauai	 Hawaiian Islands	 United States
Kaukura	Palliser Islands,  Tuamotus,  French Polynesia	 France
Kaʻula	 Hawaiian Islands	 United States
Kavaratti	Lakshadweep	 India
Kayak	Gulf of Alaska,  Alaska	 United States
Kea	Cyclades	 Greece
Keewaydin	 Florida	 United States
Kefalonia	Ionian Islands	 Greece
Kelleys	Lake Erie,  Ohio	 United States
Kelly	Mississippi River,  Illinois	 United States
Kelly's	Conception Bay,  Newfoundland and Labrador	 Canada
Kenosha	Lake Abitibi  Ontario	 Canada
Kentucky Bend Bar	Mississippi River,  Arkansas and  Mississippi	 United States
Keppel	 Falkland Islands	 United Kingdom
Keri	Gulf of Finland	 Estonia
Keros	Cyclades	 Greece
Kerrera	Inner Hebrides	 Scotland
Keskmine Vaika	Vaika Islands	 Estonia
Kesselaid		 Estonia
Keswick Island	Queensland	 Australia
Key Biscayne	Biscayne Bay,  Florida	 United States
Key Haven	Florida Keys,  Florida	 United States
Key Largo	Florida Keys,  Florida	 United States
Key West	Florida Keys,  Florida	 United States
Key Vaca	Florida Keys,  Florida	 United States
Khalki	Dodecanese	 Greece
Kharg	Persian Gulf	 Iran
Khvostof	Rat Islands group of the Aleutian Islands,  Alaska	 United States
Kigigak	Ninglick River,  Alaska	 United States
Kihnu	Gulf of Riga	 Estonia
Kikaigashima	Amami Islands part of the Satsunan Islands part of the Ryukyu Islands	 Japan
Kila		 Cyprus
Kili	Ralik Chain	 Marshall Islands
Kili Holm	The North Isles,  Orkney Islands	 Scotland
Killygowan	Upper Lough Erne	 Ireland
Killisnoo	Alexander Archipelago,  Alaska	 United States
Kiltan	Lakshadweep	 India
Kimolos	Cyclades	 Greece
Kinali	Prince's Islands	 Turkey
Kinaros	Dodecanese	 Greece
King	 British Columbia	 Canada
King	Bering Sea,  Alaska	 United States
King	Bass Strait,  Tasmania	 Australia
King George	South Shetland Islands	Claimed by:
Argentine Antarctica,  Argentina,
 Antártica Chilena Province of  Chile, and
 British Antarctic Territory of the  United Kingdom
King	Allegheny River,  Pennsylvania	 United States
King's	River Shannon	 Ireland
King's	Georgian Bay  Ontario	 Canada
King William	 Nunavut	 Canada
Kinmen (Quemoy)	Kinmen County	 Republic of China
Kinnausy	Lower Lough Erne	 Ireland
Kiritimati	Line Islands	 Kiribati
Kis-Tisza-sziget	Tisza	 Hungary
Kish	Persian Gulf	 Iran
Kiska	Rat Islands group of the Aleutian Islands,  Alaska	 United States
Kita daitō	Daitō Islands part of the Ryukyu Islands	 Japan
Kita Kojima	Senkaku Islands	 Japan
Kitchener	Lake Huron,  Ontario	 Canada
Kithnos	Cyclades	 Greece
Kleides		 Cyprus
Klein Bonaire	 Netherlands Antilles	 Kingdom of the Netherlands
Klein Curaçao	 Netherlands Antilles	 Kingdom of the Netherlands
Klippa	Haapsalu Bay	 Estonia
Kloostrisaar	Lake Pühajärv	 Estonia
Knarrholmen	Southern Gothenburg Archipelago	 Sweden
Knight	Lake Champlain,  Vermont	 United States
Knockemdown Key	Florida Keys,  Florida	 United States
Knox Atoll	Ratak Chain	 Marshall Islands
Kobjeltak	Arno Atoll	 Marshall Islands
Koch	 Nunavut	 Canada
Kodakarajima	Tokara Islands part of the Satsunan Islands part of the Ryukyu Islands	 Japan
Kodiak	Kodiak Archipelago,  Alaska	 United States
Koh Kong		 Cambodia
Koh Polawan		 Cambodia
Koh Rong	Kampong Som Group of Islands	 Cambodia
Koh Rong Samlon	Kampong Som Group of Islands	 Cambodia
Koh Russei		 Cambodia
Koh Sdach		 Cambodia
Koh Sess		 Cambodia
Koh Tang	Kampong Som Group of Islands	 Cambodia
Koh Thass		 Cambodia
Koh Traolach		 Cambodia
Koh Treas		 Cambodia
Kohama	Yaeyama Islands part of the Sakishima Islands part of the Ryukyu Islands	 Japan
Kőhidi-sziget		 Hungary
Kõinastu laid	Väinameri Sea	 Estonia
Koipsi	Kolga Bay	 Estonia
Kokanongwi	Georgian Bay,  Ontario	 Canada
Kolfage	Lake Huron,  Ontario	 Canada
Kolmenasva	Matsalu Bay	 Estonia
Koločep	Elafit islands	 Croatia
Koltur	 Faroe Islands	 Denmark
Kolyuchin	Chukchi Sea Group	 Russia
Koński Smug	Oder Lagoon islands	 Poland
Koppos		 Cyprus
Korčula	Central Dalmatian Archipelago, Adriatic Sea	 Croatia
Kordylia		 Cyprus
Kõrksaar	Gulf of Riga	 Estonia
Kornati	Kornati archipelago	 Croatia
Korom-sziget	Tisza	 Hungary
Kós	Dodecanese	 Greece
Kosa Meechkyn	Bering Sea Group	 Russia
Koster Islands		 Sweden
Koufonisi	Cyclades	 Greece
Kowloon Rock	 Hong Kong	 China
Koyama	Bajuni Islands	 Somalia
Kozloduy	Danube River	 Bulgaria
Kozushima	Izu Islands	 Japan
Krassi	Gulf of Finland	 Estonia
Kräsuli	Tallinn Bay	 Estonia
Kreenholm	Narva River	 Estonia
Krk		 Croatia
Krenitzin	Fox Islands group of the Aleutian Islands,  Alaska	 United States
Kruzof	Alexander Archipelago,  Alaska	 United States
Ksamil Islands	Ionian Islands	 Albania
Kuba-jima	Senkaku Islands	 Japan
Kubbar	Persian Gulf	 Kuwait
Kuchinoerabushima	Osumi Islands part of the Satsunan Islands part of the Ryukyu Islands	 Japan
Kuchinoshima	Tokara Islands part of the Satsunan Islands part of the Ryukyu Islands	 Japan
Kugong	Belcher Islands,  Nunavut	 Canada
Kuiu	Alexander Archipelago,  Alaska	 United States
Kumari	Väinameri Sea	 Estonia
Kumbli	Tallinn Bay	 Estonia
Kumejima	Okinawa Islands part of the Ryukyu Islands	 Japan
Kunoy	 Faroe Islands	 Denmark
Kuper	Gulf Islands,  British Columbia	 Canada
Kupreanof	Alexander Archipelago,  Alaska	 United States
Kurima	Miyako Islands part of the Sakishima Islands part of the Ryukyu Islands	 Japan
Kuroshima	Yaeyama Islands part of the Sakishima Islands part of the Ryukyu Islands	 Japan
Kuruvadweep	Kabini River, Kerala	 India
Kuusisto		 Finland
Kvaløya		 Norway
Kvitsøy	Kvitsøy islands, Rogaland	 Norway
Kvitøya	Svalbard	 Norway
Kwajalein	Ralik Chain	 Marshall Islands
Kyra Panagia	Sporades	 Greece
Kythira	Ionian Islands	 Greece
Kythnos	Cyclades	 Greece
Kyūshū	Japanese Archipelago	 Japan
La Grange	Mississippi River,  Illinois	 United States
Lae Atoll	Ralik Chain	 Marshall Islands
Læsø	Kattegat	 Denmark
Lady's Holm	 Shetland Islands	 Scotland
Lagousa	Cyclades	 Greece
Lahesaar	Gulf of Finland	 Estonia
Laidu	Küdema Bay, Baltic Sea	 Estonia
Laika	Shepherd Islands	 Vanuatu
Isle La Motte	Lake Champlain,  Vermont	 United States
Lamb Holm	The South Isles,  Orkney Islands	 Scotland
Lamba	 Shetland Islands	 Scotland
Lambasaar	Pärnu Bay, Gulf of Riga	 Estonia
Lambay		 Ireland
Lamma	Islands District,  Hong Kong	 China
Lampedusa	Pelagian Islands	 Italy
Lampione	Pelagian Islands	 Italy
Lamu	Lamu Islands	 Kenya
Lanai	Hawaiian Islands,  Hawaii	 United States
Lanaux	Bastian Bay,  Louisiana	 United States
Langeland		 Denmark
Langenwerder		 Germany
Langeoog	East Frisian Islands	 Germany
Langkawi	 Kedah	 Malaysia
Langli	North Frisian Islands	 Denmark
Langor	Arno Atoll	 Marshall Islands
Langøya	Vesterålen	 Norway
Lankiam Cay	Spratley Islands	Disputed between:
 China,
 Republic of China,
 Vietnam,
 Brunei,
 Philippines, and
 Malaysia
Lantau	Pearl River,  Hong Kong	 China
Lanz	Scott Islands,  British Columbia	 Canada
Lanzarote	 Canary Islands	 Spain
Larak	Persian Gulf	 Iran
Lasqueti	Gulf Islands,  British Columbia	 Canada
Lastovo		 Croatia
Lau	Admiralty Islands	 Papua New Guinea
Laughery	Ohio River,  Kentucky	 United States
Lauley	Gloucester Pool  Ontario	 Canada
Laurie	South Orkney Islands	Claimed by:
 the United Kingdom as part of the  Falkland Islands and by
 Argentina
Laurisaar	Baltic Sea	 Estonia
Lausma	Baltic Sea	 Estonia
Lavan	Persian Gulf	 Iran
Lavezzi	 Corsica	 France
Lazaretto	Ionian Islands	 Greece
Lebre	Alentejo islands	 Portugal
Lefkada	Ionian Islands	 Greece
Leftus	Lower Lough Erne	 Ireland
Leipsoi	Dodecanese	 Greece
Lélépa	Shepherd Islands	 Vanuatu
Lemnos	North Aegean Islands	 Greece
Lennox	 Antártica Chilena Province	 Chile
Leros	Dodecanese	 Greece
Lesbos	North Aegean Islands	 Greece
Lesser Mount Changtu	Zhoushan Archipelago	 China
Lesser Mount Yang	Zhoushan Archipelago	 China
Lesser Tunbs	Persian Gulf	 Iran
Leung Shuen Wen	 Hong Kong	 China
Levanzo	Aegadian Islands	 Italy
Levitha	Dodecanese Islands	 Greece
Lewis	Thimble Islands,  Connecticut	 United States
Leyte	Visayas	 Philippines
Lezíria Internacional	Alentejo islands	 Portugal
Liancourt Rocks		Administered by  South Korea.
Claimed by:  Japan
Lib	Ralik Chain	 Marshall Islands
Lidingö	Stockholm archipelago	 Sweden
Lido	Venetian Lagoon	 Italy
Lieutenant	Wellfleet Harbor, Cape Cod,  Massachusetts	 United States
Lihou	Channel Islands	 Guernsey
Liialaid	Väinameri Sea	 Estonia
Liisi laid		 Estonia
Liivakari	Gulf of Finland	 Estonia
Likiep Atoll	Ratak Chain	 Marshall Islands
Likoma	Lake Malawi	 Malawi
Lindau	Lake Constance	 Germany
Lindos	Dodecanese Islands	 Greece
Linga Holm	The North Isles, Orkney Islands	 Scotland
Linga near Muckle Roe	 Shetland Islands	 Scotland
Linga near Shetland Mainland	 Shetland Islands	 Scotland
Linga near Yell	 Shetland Islands	 Scotland
Linnusitamaa	Gulf of Riga	 Estonia
Linosa	Pelagian Islands	 Italy
Linua	Torres Islands	 Vanuatu
Lipari	Aeolian Islands	 Italy
Lismore	Inner Hebrides	 Scotland
Lítla Dímun	 Faroe Islands	 Denmark
Little Andaman	Andaman Islands	 India
Little Bear	Lake Winnipesaukee,  New Hampshire	 United States
Little Birch	Lake Winnipesaukee,  New Hampshire	 United States
Little Camp	Lake Winnipesaukee,  New Hampshire	 United States
Little Cayman	 Cayman Islands	 United Kingdom
Little Kitchener	Lake Huron,  Ontario	 Canada
Little Wellington Island	Aisén Region	 Chile
Little Green	 Hong Kong	 China
Little Hurricane	Ohio River,  Kentucky	 United States
Little Mud	 Louisiana	 United States
Little Roe	 Shetland Islands	 Scotland
Little Sixmile	Lake Winnipesaukee,  New Hampshire	 United States
Little Skellig	Skellig Islands	 Ireland
Little Wellington Island	Aisén Region	 Chile
Liuheng	Zhoushan Archipelago	 China
Lively	 Falkland Islands	 United Kingdom
Livingston	South Shetland Islands	Claimed by:
Argentine Antarctica,  Argentina,
 Antártica Chilena Province of  Chile, and
 British Antarctic Territory of the United Kingdom
Livø		 Denmark
Ljusterö	Stockholm archipelago	 Sweden
Llanddwyn		 Wales
Loaita	Spratley Islands	Disputed between:
 China,
 Republic of China,
 Vietnam,
 Brunei,
 Philippines, and
 Malaysia
Lockes	Lake Winnipesaukee,  New Hampshire	 United States
Loh	Torres Islands	 Vanuatu
Lokrum		 Croatia
Lolland		 Denmark
Lombo	Ribatejo islands	 Portugal
Lombok	Lesser Sunda Islands	 Indonesia
Lonely	Georgian Bay  Ontario	 Canada
Long	Tennessee River,  Alabama and  Tennessee	 United States
Long	 Alabama	 United States
Long	 New York	 United States
Long	Bahamas	 Bahamas
Long	 Nova Scotia	 Canada
Long	Hudson Bay,  Nunavut	 Canada
Long	Leeward Islands	 Antigua and Barbuda
Long	Whitsunday Islands,  Queensland	 Australia
Long	 New South Wales	 Australia
Long	Gull Lake  Ontario	 Canada
Long		 Papua New Guinea
Long	Marlborough Sounds	 New Zealand
Long	Fiordland	 New Zealand
Long	Seychelles	 Seychelles
Long		 Turkey
Long	Poole Harbour	 United Kingdom
Long	Langstone Harbour	 United Kingdom
Long	Mississippi River,  Illinois	 United States
Long	Boston Harbor,  Massachusetts	 United States
Long	Apostle Islands,  Wisconsin	 United States
Lookout	Georgian Bay  Ontario	 Canada
Loon	Lake Shetek,  Minnesota	 United States
Loon	Lake Winnipesaukee,  New Hampshire	 United States
Loon	Georgian Bay  Ontario	 Canada
Looney	Tennessee River,  Tennessee	 United States
Loosahatchie Bar	Mississippi River,  Tennessee	 United States
Lopez	San Juan Islands,  Washington	 United States
Lopud	Elafit Islands	 Croatia
Lord Howe	Lord Howe Islands,  New South Wales	 Australia
Los Negros	Admiralty Islands	 Papua New Guinea
Lošinj		 Croatia
Lõuna-Malusi	Malusi Islands, Gulf of Finland	 Estonia
Low	South Shetland Islands	Claimed by:
Argentine Antarctica,  Argentina,
 Antártica Chilena Province of  Chile, and
 British Antarctic Territory of the United Kingdom
Lower Grey Cloud	 Minnesota	 United States
Loyalty	a dependency of the French territory of New Caledonia	 France
Lucas	Lake Huron,  Ontario	 Canada
Lucas	 Western Australia	 Australia
Luing	Inner Hebrides	 Scotland
Lummi Island	San Juan Islands,  Washington	 United States
Lunga	Inner Hebrides	 Scotland
Lunna Holm	 Shetland Islands	 Scotland
Lupa-sziget		 Hungary
Lusty Beg	Lower Lough Erne	 Ireland
Lusty more	Lower Lough Erne	 Ireland
Lütjehörn	East Frisian Islands	 Germany
Luzon	Luzon	 Philippines
Lyal	Lake Huron,  Ontario	 Canada
Lyø		 Denmark
Ma Wan	 Hong Kong	 China
Maadhiguvaru	Gaafu Alif Atoll	 Maldives
Machias Seal	Disputed Between  Maine and  New Brunswick	Disputed between
 United States and  Canada
Mackay	 North Carolina and  Virginia	 United States
Mackenzie King	Queen Elizabeth Islands,  Nunavut and  Northwest Territories	 Canada
Mackinac	Lake Huron,  Michigan	 United States
Maclellan	Tennessee River,  Tennessee	 United States
Macquarie	Southern Ocean,  Tasmania	 Australia
Madagascar	Indian Ocean	 Madagascar
La Maddalena	 Sardinia	 Italy
Iles des Madeleines		 Senegal
Madeline	Lake Superior,  Wisconsin	 United States
Madeira	 Madeira	 Portugal
Madrid Bar	Mississippi River,  Kentucky	 United States
Madura	East Java	 Indonesia
Maewo	Pacific Ocean	 Vanuatu
Mafia	Tanzanian Spice Islands	 Tanzania
Isla Magdalena	 Baja California Sur	 Mexico
Magerøya	Nordkapp, Finnmark	 Norway
Mageshima	Osumi Islands part of the Satsunan Islands group of the Ryukyu Islands	 Japan
Magusaiai	Shortland Islands	 Solomon Islands
Maiao	Windward Islands, Society Islands,  French Polynesia	 Overseas Lands of France
Mainau	Lake Constance	 Germany
Mainland	 Shetland Islands	 Scotland
Main Station	Lake Huron,  Ontario	 Canada
Majorca	 Balearic Islands	 Spain
Majuli	Brahmaputra River, Assam	 India
Majuro	Ratak Chain	 Marshall Islands
Makada	Duke of York Islands	 Papua New Guinea
Makanrushi	Kuril Islands,  Sakhalin Oblast	 Russia
Makatea	 Tuamotus,  French Polynesia	 France
Makema	 Tuamotus,  French Polynesia	 France
Makura	Shepherd Islands	 Vanuatu
Malakula	New Hebrides	 Vanuatu
Malcolm	 British Columbia	 Canada
Malden	Line Islands	 Kiribati
Mal Grad	Lake Prespa	 Albania
Mallard	Lake Audubon,  North Dakota	 United States
Malo	Pacific Ocean	 Vanuatu
Maloelap Atoll	Ratak Chain	 Marshall Islands
Malpelo		 Colombia
Malta	Maltese islands	 Malta
Makronisos		 Greece
Mamula	Adriatic Sea	 Montenegro
Man	 Ontario	 Canada
Mana	Porirua Harbour	 New Zealand
Manda	Lamu Archipelago	 Kenya
Mandø	North Frisian Islands	 Germany
Mangaia	Cook Islands	 Cook Islands
Manhattan	 New York	 United States
Manihi	King George Islands,  Tuamotus,  French Polynesia	 France
Manihiki	Cook Islands	 Cook Islands
Manilaid	Gulf of Riga	 Estonia
Manitou	Lake Superior,  Michigan	 United States
Manitou	Apostle Islands,  Wisconsin	 United States
Manitoulin	Lake Huron,  Ontario	 Canada
Manoel	Maltese islands	 Malta
Mansel	 Nunavut	 Canada
Manuae	Cook Islands	 Cook Islands
Manuae	Leeward Islands, Society Islands, French Polynesia	 French Polynesia
Manus	Admiralty Islands	 Papua New Guinea
Maple	Mississippi River,  Missouri	 United States
Ilha de Marajó		 Brazil
Marawah, United Arab Emirates	Persian Gulf	 United Arab Emirates
Mare	 California	 United States
Marechal	Beira Baixa islands	 Portugal
Marettimo	Aegadian Islands	 Italy
Isla Margarita	Nueva Esparta	 Venezuela
Margitsziget	Danube River	 Hungary
Maria	 Tasmania	 Australia
Maria Cleofas	Islas Marías,  Nayarit	 Mexico
Maria Madre	Islas Marías,  Nayarit	 Mexico
Maria Magdalena[disambiguation needed]	Islas Marías,  Nayarit	 Mexico
Marie-Galante	 Guadeloupe, Lesser Antilles	 France
Marinduque	Luzon	 Philippines
Marinha Nova	Beira Litoral islands	 Portugal
Mark	Lake Winnipesaukee,  New Hampshire	 United States
Marmara	Marmara Islands	 Turkey
Marrowstone	Puget Sound,  Washington	 United States
Marsh	 Louisiana	 United States
Marshall	 Maine	 United States
Martha's Vineyard	 Massachusetts	 United States
Martin	 Louisiana	 United States
Ilhas Martin Vaz	Atlantic Ocean	 Brazil
Martinhal	Algarve islands	 Portugal
Martuska-sziget	Danube River	 Hungary
Maskali		 Djibouti
Masnedø		 Denmark
Mason	Mississippi River,  Missouri	 United States
Mason's	Mystic River,  Connecticut	 United States
Massey	Queen Elizabeth Islands,  Nunavut	 Canada
Matadouce	Beira Litoral islands	 Portugal
Matagorda	 Texas	 United States
Mataiva	Palliser Islands,  Tuamotus,  French Polynesia	 France
Matakana	Bay of Plenty	 New Zealand
Mataso	Shepherd Islands	 Vanuatu
Mathraki	Ionian Islands	 Greece
Matia	San Juan Islands,  Washington	 United States
Matinicus	 Maine	 United States
Matiu	Wellington Harbour	 New Zealand
Maatsukyer	Maatsuyker Island Group,  Tasmania	 Australia
Matsu	Lienchang County	 Republic of China
Matty	 Nunavut	 Canada
Matua	Kuril Islands,  Sakhalin Oblast	 Russia
Matureivavao	Acteon Group,  Tuamotus,  French Polynesia	 France
Maupiti	Windward Islands, Society Islands,  French Polynesia	 Overseas Lands of France
Maud	Marlborough Sounds	 New Zealand
Maui	Hawaiian Islands,  Hawaii	 United States
Mauke	Cook Islands	 Cook Islands
Mauritius	Mascarene Islands	 Mauritius
Maurice Island		 Latvia
Maury	Puget Sound,  Washington	 United States
Maxwell	Georgian Bay  Ontario	 Canada
Mayne	Gulf Islands,  British Columbia	 Canada
Mayor	Bay of Plenty	 New Zealand
Mayotte	Comoros	 France
Mazaki		 Cyprus
McCallum	Lake Huron,  Ontario	 Canada
McCauley	 British Columbia	 Canada
McCormicks	Susquehanna River,  Pennsylvania	 United States
McCoy	Georgian Bay  Ontario	 Canada
McCoy	Mississippi River,  Illinois	 United States
Mcevers	Illinois River,  Illinois	 United States
McLaren	Georgian Bay  Ontario	 Canada
McNeil	Puget Sound,  Washington	 United States
McQuade	Georgian Bay  Ontario	 Canada
McQueens	 Georgia	 United States
Isle of Meadows	 New York	 United States
Medny	Komandorski Islands,  Alaska	Owned by the  United States, controlled by  Russia
Meganisi	Ionian Islands	 Greece
Mehetia	Windward Islands, Society Islands,  French Polynesia	 Overseas Lands of France
Meighen	Queen Elizabeth Islands,  Nunavut	 Canada
Mejit	Ratak chain	 Marshall Islands
Melbourne	 Nunavut	 Canada
Mele	Melanesia	 Vanuatu
Mellum	East Frisian Islands	 Germany
Melville	Queen Elizabeth Islands,  Nunavut and  Northwest Territories	 Canada
Melvin	Lake Winnipesaukee,  New Hampshire	 United States
Memmert	East Frisian Islands	 Germany
Mendicant	Barataria Bay,  Louisiana	 United States
Merasheen	 Newfoundland and Labrador	 Canada
Mercer	Lake Washington,  Washington	 United States
Mercury		 New Zealand
Merelava	Banks Islands	 Vanuatu
Merig	Banks Islands	 Vanuatu
Metinic	 Maine	 United States
Metoma	Torres Islands	 Vanuatu
Michigan	Lake Superior,  Wisconsin	 United States
Michipicoten	Lake Superior,  Ontario	 Canada
Middle Andaman	Andaman Islands	 India
Middle Bass	Bass Islands,  Ohio	 United States
Middle Brewster	Boston Harbor,  Massachusetts	 United States
Middle Duck	Lake Huron,  Ontario	 Canada
Middle Ground	Mississippi River,  Mississippi	 United States
Middle Ground Coastal Battery	Maharashtra	 India
Middle	Lake Erie,  Ontario	 Canada
Middle	Ohio River,  West Virginia	 United States
Middle	Nightingale Islands,  Tristan da Cunha	 British overseas territory of  Saint Helena, Ascension and Tristan da Cunha
Midgarth	Orkney Islands	 Scotland
Mikurajima	Izu Islands	 Japan
Mile	Lake Winnipesaukee,  New Hampshire	 United States
Mili Atoll	Ratak Chain	 Marshall Islands
Mill	 Nunavut	 Canada
Mill Creek	Ohio River,  West Virginia	 United States
Mill Rock	 New York	 United States
Milos	Cyclades	 Greece
Mimami daitō	Daitō Islands part of the Ryukyu Islands	 Japan
Minami Kojima	Senkaku Islands	Disputed by  Japan and  China
Mindanao	Mindanao group	 Philippines
Minicoy	Lakshadweep	 India
Minister	Lake Winnipesaukee,  New Hampshire	 United States
Mink	Georgian Bay  Ontario	 Canada
Mink	Lake Winnipesaukee,  New Hampshire	 United States
Minna	Miyako Islands part of the Sakishima Islands part of the Ryukyu Islands	 Japan
Minnicognashene	Georgian Bay  Ontario	 Canada
Minorca	 Balearic Islands	 Spain
Minquiers	Channel Islands	 Jersey
Minu	Persian Gulf	 Iran
Mioko	Duke of York Islands	 Papua New Guinea
Miserable	Rice Lake,  Illinois	 United States
Mishka	Danube River	 Bulgaria
Miskan	Persian Gulf	 Kuwait
Misool	Raja Ampat Islands	 Indonesia
Mistaken	Lake Abitibi,  Ontario	 Canada
Mitchell	 Louisiana	 United States
Mitchell Key	 Louisiana	 United States
Mitiaro	Cook Islands	 Cook Islands
Mitkof	Alexander Archipelago,  Alaska	 United States
Mitraha	Lake Tana	 Ethiopia
Miyakejima	Izu Islands	 Japan
Miyakojima	Miyako Islands part of the Sakishima Islands part of the Ryukyu Islands	 Japan
Mjältön	High Coast	 Sweden
Mljet	Adriatic Sea	 Croatia
Mo-do-Meio	Beira Litoral islands	 Portugal
Mohácsi-sziget	Danube River	 Hungary
Mohawk	Lake Erie,  Ontario	 Canada
Mohéli	Comoros	 Comoros
Mohni	Gulf of Finland	 Estonia
Île-aux-Moines	Gulf of Morbihan	 France
Moínho	Alentejo islands	 Portugal
Mokoia	Lake Rotorua	 New Zealand
Molara		 Italy
Molène	Archipel de Molène	 France
Molokai	Hawaii	 United States
Møn		 Denmark
Moneron	Strait of Tartary,  Sakhalin Oblast	 Russia
Monhegan	 Maine	 United States
Monkey	 Louisiana	 United States
Monocanock	Susquehanna River,  Pennsylvania	 United States
Monomoy	 Massachusetts	 United States
Mont Saint-Michel	Normandy	 France
Monte Branco	Alentejo islands	 Portugal
Monte Farinha	Beira Litoral islands	 Portugal
Montecristo	Tuscan Archipelago	 Italy
Montserrat 	Leeward Islands of the Lesser Antilles	 Overseas territory of the United Kingdom
Monument	Shepherd Islands	 Vanuatu
Moodie	 Nunavut	 Canada
Moon	Georgian Bay  Ontario	 Canada
Moorea	Windward Islands, Society Islands,  French Polynesia	 Overseas Lands of France
Mopelia	Windward Islands, Society Islands,  French Polynesia	 Overseas Lands of France
Moresby	Queen Charlotte Islands,  British Columbia	 Canada
Morfil	River Senegal	 Senegal
Morgan	 Louisiana	 United States
Morraceira	Beira Litoral islands	 Portugal
Morris	Charleston Harbor,  South Carolina	 United States
Mors	Limfjorden	 Denmark
Mortland	Illinois River,  Illinois	 United States
Moruroa	 Tuamotus,  French Polynesia	 France
Moscos Islands	Tanintharyi Region	 Burma
Mosenthein	Mississippi River,  Illinois	 United States
Moser	Mississippi River,  Missouri	 United States
Moskenesøya	Lofoten	 Norway
Moso	Shepherd Islands	 Vanuatu
Mosterøy	Island Rennesøy municipality, Ryfylke Islands, Rogaland	 Norway
Mota	Banks Islands	 Vanuatu
Mota Lava	Banks Islands	 Vanuatu
Motiti	Bay of Plenty	 New Zealand
Motu One	Windward Islands, Society Islands,  French Polynesia	 Overseas Lands of France
Motuihe	Hauraki Gulf	 New Zealand
Motukaramarama	Motukawao Islands, Hauraki Gulf	 New Zealand
Moturata	Mouth of the Taieri River	 New Zealand
Moturua	Motukawao Islands, Hauraki Gulf	 New Zealand
Motutapu	Hauraki Gulf	 New Zealand
Motuwi	Motukawao Islands, Hauraki Gulf	 New Zealand
Moucha		 Djibouti
Moul of Eswick	 Shetland Islands	 Scotland
Mount Ao	Zhoushan Archipelago	 China
Mount Desert	 Maine	 United States
Mount Maji	Zhoushan Archipelago	 China
Mousa	 Shetland Islands	 Scotland
Mouse	Lake Erie,  Ohio	 United States
Moutoa	Whanganui River	 New Zealand
Mowat	Georgian Bay (Parry Sound),  Ontario	 Canada
Muck	Inner Hebrides	 Scotland
Muckle Green Holm	The North Isles,  Orkney Islands	 Scotland
Muckle Flugga	 Shetland Islands	 Scotland
Muckle Ossa	 Shetland Islands	 Scotland
Muckle Roe	 Shetland Islands	 Scotland
Mud	Detroit River,  Michigan	 United States
Mud Grass	 Louisiana	 United States
Mud Island Shoal	Delaware River,  Pennsylvania	 United States
Muharraq	Persian Gulf	 Bahrain
Muhu	West Estonian archipelago; Baltic Sea	 Estonia
Isla Mujeres	Caribbean Sea,  Quintana Roo	 Mexico
Mukawwar		 Sudan
Mulberry	James River,  Virginia	 United States
Mull	Inner Hebrides	 Scotland
Mumfort	York River,  Virginia	 United States
Murano	Venetian Lagoon,  Veneto	 Italy
Murphy	Allegheny River,  Pennsylvania	 United States
Murray	Torres Strait Islands,  Queensland	 Australia
Murry	Thousand Islands,  New York	 United States
Murter	Adriatic Sea	 Croatia
Musholm	Islands of the Great Belt	 Denmark
Muskeget	 Massachusetts	 United States
Muskingum	Ohio River,  West Virginia	 United States
Mussau	St. Matthias Islands	 Papua New Guinea
Mussel Rock	 California	 United States
Mustang	Port Aransas,  Texas	 United States
Mustapha	Ohio River,  West Virginia	 United States
Myingun Island	Rakhine State	 Burma
Mykines	 Faroe Islands	 Denmark
Mykonos	Cyclades	 Greece
Na Mokulua	 Hawaiian Islands	 United States
Naart	Upper Lough Erne	 Ireland
Nærøya		 Norway
Nagy-Pandúr-sziget	Danube River	 Hungary
Nahaleg	Dahlak Archipelago	 Eritrea
Naissaar	Tallinn Bay, Gulf of Finland	 Estonia
Nakanoshima	Tokara Islands part of the Satsunan Islands part of the Ryukyu Islands	 Japan
Namdrick Atoll	Ralik Chain	 Marshall Islands
Namorik	Ralik Chain	 Marshall Islands
Namu Atoll	Ralik Chain	 Marshall Islands
Namyit	Spratley Islands	Disputed between:
 China,
 Republic of China,
 Vietnam,
 Brunei,
 Philippines, and
 Malaysia
Nancowry	Nicobar Islands	 India
Nanshan	Spratley Islands	Disputed between:
 China,
 Republic of China,
 Vietnam,
 Brunei,
 Philippines, and
 Malaysia
Nantucket	 Massachusetts	 United States
Napuka	 Tuamotus,  French Polynesia	 France
Nargin	Baku Bay	 Azerbaijan
Nashawena	Elizabeth Islands,  Massachusetts	 United States
Nassau	Cook Islands	 Cook Islands (self-governing in free association with New Zealand)
Natuna	Natuna Islands	 Indonesia
Nauru		 Nauru
Naushon	Elizabeth Islands,  Massachusetts	 United States
Navassa	Greater Antilles	Claimed by the  United States and  Haiti
Navy	Niagara River,  Ontario	 Canada
Naxos	Cyclades	 Greece
Ndrova	Admiralty Islands	 Papua New Guinea
Neal	Ohio River,  West Virginia	 United States
Necker	 Northwestern Hawaiian Islands	 United States
Necker	 British Virgin Islands	 United Kingdom
Neebish Island	St. Marys River,  Michigan	 United States
Negei	 British Columbia	 Canada
Negit	Mono Lake,  California	 United States
Negros	Visayas	 Philippines
Nell	Kwajalein Atoll, Ralik Chain	 Marshall Islands
Nelson	 Alaska	 United States
Nelson	South Shetland Islands	Claimed by:
Argentine Antarctica,  Argentina,
 Antártica Chilena Province of  Chile, and
 British Antarctic Territory of the United Kingdom
Nengonengo	 Tuamotus,  French Polynesia	 France
Nerlandsøya		 Norway
Nesøya	Salten, Nordland	 Norway
Neuwerk	Wadden Sea	 Germany
Neville	 Pennsylvania	 United States
Nevis	Leeward Islands group of the Lesser Antilles	 Saint Kitts and Nevis
New Britain	Bismarck Archipelago	 Papua New Guinea
New Era Bar	Willamette River,  Oregon	 United States
New Ireland	Bismarck Archipelago	 Papua New Guinea
New	 Falkland Islands	 United Kingdom
New Guinea	Melanesia	Divided between  Indonesia and  Papua New Guinea
Newfoundland	 Newfoundland and Labrador	 Canada
New Hanover	Bismarck Archipelago	 Papua New Guinea
New Mecklenburg	Bismarck Archipelago	 Papua New Guinea
New World	 Newfoundland and Labrador	 Canada
Ngamotukaraka	Motukawao Islands, Hauraki Gulf	 New Zealand
Ngofonua	Tongatapu group	 Tonga
Ngumi	Bajuni Islands	 Somalia
Nguna	Shepherd Islands	 Vanuatu
Ngwēl	Torres Islands	 Vanuatu
Niau	 Tuamotus,  French Polynesia	 France
Nichol	Buckhorn Lake  Ontario	 Canada
Nicholson	Allegheny River,  Pennsylvania	 United States
Nicollet	Mississippi River,  Minnesota	 United States
Nicomen	 British Columbia	 Canada
Nightingale	 Tristan da Cunha	 British overseas territory of  Saint Helena, Ascension and Tristan da Cunha
Nihiru	 Tuamotus,  French Polynesia	 France
Nihoa	 Northwestern Hawaiian Islands	 United States
Ni'ihau	 Hawaiian Islands	 United States
Niijima	Izu Islands	 Japan
Nikumaroro	Phoenix Islands	 Kiribati
Ninemile	Allegheny River,  Pennsylvania	 United States
Nine Mile	Mississippi River,  Iowa	 United States
Niniva	Lifuka group of the Ha'apai group	 Tonga
Nisida	Flegree Islands	 Italy
Nisyros	Dodecanese	 Greece
Niuafo'ou	Niua group	 Tonga
Niuatoputapu	Niua group	 Tonga
Niue		 Niue (self-governing in free association with New Zealand)
Nixes Mate	Boston Harbor,  Massachusetts	 United States
Nizki	Semchi Islands group of the Near Islands in the Aleutian Islands,  Alaska	 United States
Île de Noirmoutier	Vendée,  Pays de la Loire	 France
Île aux Noix	Richelieu River,  Quebec	 Canada
Nólsoy	 Faroe Islands	 Denmark
Nomans Land	 Massachusetts	 United States
Nomuka	'Otu Mu'omu'a group of the Ha'apai group	 Tonga
Nomuka iki	'Otu Mu'omu'a group of the Ha'apai group	 Tonga
No-Name	Allegheny River,  Pennsylvania	 United States
Nonamesset	Elizabeth Islands,  Massachusetts	 United States
Nootka	 British Columbia	 Canada
Nora	Dahlak Archipelago	 Eritrea
Nord-Kvaløy		 Norway
Nordaustlandet	Northeast Land, Svalbard	 Norway
Norderney	East Frisian Islands	 Germany
Norderoog	North Frisian Islands	 Germany
Nordmarsch-Langeneß	North Frisian Islands	 Germany
Nordre Kvaløy		 Norway
Nordstrand	North Frisian Islands	 Germany
Nordstrandischmoor	North Frisian Islands	 Germany
Norfolk Island 	Norfolk Island	 Australia
North	New Zealand	 New Zealand
North Andaman	Andaman Islands	 India
North Bass	Lake Erie,  Ohio	 United States
North Brother	Andaman Archipelago, Indian Ocean	 India
North Brother	East River,  New York	 United States
North Brother	Chagos Archipelago, Indian Ocean	 United Kingdom
North Brother	Atlantic Ocean,  Connecticut	 United States
North Brother	Seven Brothers, Bab-el-Mandeb	 Djibouti
North Dumpling	Fisher's Island Sound,  New York	 United States
North Harbour	Lake Erie,  Ontario	 Canada
North Haven	Penobscot Bay,  Maine	 United States
North Havra	 Shetland Islands	 Scotland
North Hero	Lake Champlain,  Vermont	 United States
North Limestone	Georgian Bay  Ontario	 Canada
North Long		 Namibia
North Manitou	Lake Michigan,  Michigan	 United States
North Otter	Georgian Bay  Ontario	 Canada
North Monomoy	Cape Cod,  Massachusetts	 United States
North Ronaldsay	The North Isles,  Orkney Islands	 Scotland
North Sentinel	Andaman Islands	 India
North Stradbroke Island	Moreton Bay Islands	 Australia
North Twin	Apostle Islands,  Wisconsin	 United States
North Uist	Outer Hebrides	 Scotland
North Watcher	Georgian Bay  Ontario	 Canada
Northeast Cay	Spratley Islands	Disputed between  China,  Republic of China,  Vietnam,  Brunei,  Philippines, and  Malaysia
Northwest	Timbalier Bay,  Louisiana	 United States
Northwest Burnt	Georgian Bay  Ontario	 Canada
Noss	 Shetland Islands	 Scotland
Nottawasaga	Georgian Bay  Ontario	 Canada
Nøtterøy	Vestfold	 Norway
Nuapapu	Vavaʻu group	 Tonga
Isla Nueva	 Antártica Chilena Province	 Chile
Nuguria	Papua New Guinea, Melanesia	 Papua New Guinea
Nuku	Tongatapu group	 Tonga
Nuku	'Otu Mu'omu'a group of the Ha'apai group	 Tonga
Nukuatea	Wallis Island	 France
Nukufaiau	'Otu Mu'omu'a group of the Ha'apai group	 Tonga
Nukufotu	Wallis Island	 France
Nukuhifala	Wallis Island	 France
Nukulei	Lulunga archipelago of the Ha'apai group	 Tonga
Nukuloa	Wallis Island	 France
Nukumanu	Papua New Guinea, Melanesia	 Papua New Guinea
Nukunione	Wallis Island	 France
Nukunukumotu	Tongatapu group	 Tonga
Nukuoro	 Pohnpei	 Federated States of Micronesia
Nukupule	Lifuka group of the Ha'apai group	 Tonga
Nukutapu	Wallis Island	 France
Nukuteatea	Wallis Island	 France
Nukutepipi	Duke of Gloucester Islands,  Tuamotus,  French Polynesia	 France
Nukutula	'Otu Mu'omu'a group of the Ha'apai group	 Tonga
Nunivak	Bering Sea,  Alaska	 United States
Nyord	Baltic Sea	 Scotland
Oahu	 Hawaii	 United States
Oak	Georgian Bay (Parry Sound)  Ontario	 Canada
Óbudai-sziget	Danube River	 Hungary
Obstruction	San Juan Islands,  Washington	 United States
Oconnel	Mississippi River,  Iowa	 United States
Ocracoke	 North Carolina	 United States
Oeno	 Pitcairn Islands	 British overseas territories
Ofidoussa	
Ogami	Miyako Islands part of the Sakishima Islands part of the Ryukyu Islands	 Japan
Oinousses		 Greece
Oki daitō	Daitō Islands part of the Ryukyu Islands	 Japan
Okikendawt	French River  Ontario	 Canada
Okinawa	Okinawa Islands part of the Ryukyu Islands	 Japan
Okinoerabujima	Amami Islands part of the Satsunan Islands part of the Ryukyu Islands	 Japan
Oland	North Frisian Islands	 Germany
Öland		 Sweden
Oleron		 France
Olib	Northern Dalmatia	 Croatia
Ombo	Ryfylke Islands, Rogaland	 Norway
Omelek	Kwajalein Atoll, Ralik Chain	 Marshall Islands
Omø	Great Belt	 Denmark
Omolkarm	Persian Gulf	 Iran
Ono	Perdito River,  Alabama	 United States
Ontong Java	Solomon Islands	 Solomon Islands
Orcas	San Juan Islands,  Washington	 United States
Öreg-sziget	Danube River	 Hungary
Orfasay	 Shetland Islands	 Scotland
Oronsay	Inner Hebrides	 Scotland
Orust		 Sweden
Izu Ōshima	Izu Islands	 Japan
Osmussaar	Gulf of Finland	 Estonia
Ostrów	Islands of Gdańsk	 Poland
Othonoi	Ionian Islands	 Greece
Otok	Bay of Kotor Islands	 Montenegro
Out Stack	 Shetland Islands	 Scotland
Outer Duck	Lake Huron,  Ontario	 Canada
Ovau	Shortland Islands	 Solomon Islands
Ovoa	Beira Litoral Islands	 Portugal
Oxeia	Ionian Islands	 Greece
Oxna	 Shetland Islands	 Scotland
Owens	Ohio River,  Kentucky	 United States
Owl		 Ireland
Oyster Rock	Maharashtra	 India
Paama	Pacific Ocean	 Vanuatu
Paden	Ohio River,  West Virginia	 United States
Padgett	 Arkansas	 United States
Padloping	 Nunavut	 Canada
Padre	 Texas	 United States
Pag	Adriatic Sea	 Croatia
Pak	Admiralty Islands	 Papua New Guinea
Pakatoa	Hauraki Gulf	 New Zealand
Palagruža	Adriatic Sea	 Croatia
Palánki-sziget	Danube River	 Hungary
Palau		 Palau
Palawan	Visayas	 Philippines
La Palma	 Canary Islands	 Spain
Palmeira	Alentejo Islands	 Portugal
Palmeira Pequena	Alentejo Islands	 Portugal
Palmerston	Cook Islands	 Cook Islands
Palm Island	 Aruba	 Kingdom of the Netherlands
Palmižana	Adriatic Sea	 Croatia
Palu'e	Lesser Sunda Islands	 Indonesia
Panarea	Aeolian Islands	 Italy
Panay	Visayas	 Philippines
Pancake	 Rhode Island	 United States
Pandora	 Nunavut	 Canada
Pangkor	 Perak	 Malaysia
Panmure	 Prince Edward Island	 Canada
Pantar	Alor Archipelago	 Indonesia
Pantelleria	Strait of Sicily	 Italy
Pap-sziget	Danube River	 Hungary
Papa	 Shetland Islands	 Scotland
Papa Little	 Shetland Islands	 Scotland
Papa Stour	 Shetland Islands	 Scotland
Papa Stronsay	The North Isles,  Orkney Islands	 Scotland
Papa Westray	The North Isles,  Orkney Islands	 Scotland
Paquetá	Guanabara Bay	 Brazil
Parker	 Alabama	 United States
Parris	 South Carolina	 United States
Paros	Cyclades	 Greece
Parrachill	Beira Litoral Islands	 Portugal
Parry	Georgian Bay  Ontario	 Canada
Pasalimani	Marmara Islands	 Turkey
Pasaran		 Indonesia
Pašman		 Croatia
Pasque	Elizabeth Islands,  Massachusetts	 United States
Pasumpahan		 Indonesia
Pate	Lamu Islands	 Kenya
Patience	 Rhode Island	 United States
Pátmos	Dodecanese	 Greece
Patos	San Juan Islands,  Washington	 United States
Patroklou	Saronic Islands	 Greece
Patton	Tennessee River,  Alabama	 United States
Paul	 Newfoundland and Labrador	 Canada
Pavell	Sabine River,  Texas	 United States
Paw Paw	 Mississippi	 United States
Pawleys	 South Carolina	 United States
Paxi	Ionian Islands	 Greece
Pea Patch	 Delaware	 United States
Peach	 Alabama	 United States
Peach Blossom		 China
Peaks	Casco Bay,  Maine	 United States
Peale	 Wyoming	 United States
Pearl	San Juan Islands,  Washington	 United States
Pearl River	 Louisiana	 United States
Pearse	 British Columbia	 Canada
Pebble	 Falkland Islands	 United Kingdom
Peberholm	artificial island at Oresund	 Denmark
Peche	Detroit River,  Ontario	 Canada
Peddocks	Boston Harbor,  Massachusetts	 United States
Pedra Branca		Claimed by  Singapore and  Malaysia
Bedra	Beira Litoral Islands	 Portugal
Pelee	Lake Erie,  Ontario	 Canada
Peleng	Kepulauan Banggai group	 Indonesia
Pelican	Lake Shala	 Ethiopia
Pelican	 Alabama	 United States
Pelican	 Louisiana	 United States
Pelican	 Missouri	 United States
Pelican	 Nevada	 United States
Pelican	 Texas	 United States
Pelican Point	 Louisiana	 United States
Pelican Roost	 Wyoming	 United States
Pellinge	Porvoo	 Finland
Pellworm	North Frisian Islands	 Germany
Pemba	Spice Islands	 Tanzania
Penang	Straits of Malacca,  Penang	 Malaysia
Pender	Gulf Islands,  British Columbia	 Canada
Peng Chau	Islands District,  Hong Kong	 China
Penguin	Angra Pequeña	 Namibia
Penguin	South Shetland Islands	Claimed by Argentine Antarctica,  Argentina,  Antártica Chilena Province,  Chile, and  British Antarctic Territory,  United Kingdom
Penikese	Elizabeth Islands,  Massachusetts	 United States
Penrhyn	Cook Islands	 Cook Islands
Pentecost	Pacific Ocean	 Vanuatu
Perceveira	Alentejo islands	 Portugal
Perdido Key	 Florida	 United States
Isla Perejil Parsley Island	Plazas de Soberanía, Strait of Gibraltar	 Spain
Perhentian Besar	Perhentian Islands	 Malaysia
Perhentian Kecil	Perhentian Islands	 Malaysia
Île Perrot	 Quebec	 Canada
Perry	Mississippi River,  Missouri	 United States
Perseverance	Lake Huron,  Ontario	 Canada
Peristera	Northern Sporades	 Greece
Peruque	Mississippi River,  Missouri	 United States
Pessegueiro	Alentejo islands	 Portugal
Pest	 New Hampshire	 United States
Petalas	Ionian Islands	 Greece
Peter I	Bellingshausen Sea	 Norway
Peters	 Alabama	 United States
Peters	 Arkansas	 United States
Petersfield	 Delaware	 United States
Petit Bois	 Mississippi	 United States
Petit de Grat	 Nova Scotia	 Canada
Petőfi-sziget		 Hungary
Petrie Island	Ottawa River, Ottawa,  Ontario	 Canada
Pettys	 New Jersey	 United States
Pfaueninsel	Havel River	 Germany
Pharaoh's	Gulf of Aqaba	 Egypt
Pharaoh's	River Thames,  England	 United Kingdom
Pharra	Mississippi River,  Missouri	 United States
Pheasant	Bidasoa River, shared between Guipuscoa and Pyrénées-Atlantiques	Shared by  Spain and  France
Philae	Nile River	 Egypt
Phillips	 Rhode Island	 United States
Phillis	Barnstable Harbor,  Massachusetts	 United States
Phillis	Ohio River,  Pennsylvania	 United States
Pholegandros	Cyclades	 Greece
Philo Brice	Timbalier Bay,  Louisiana	 United States
Pianosa	Tuscan Archipelago	 Italy
Piasa	Mississippi River,  Illinois	 United States
Pickel	French Broad River,  Tennessee	 United States
Picket	 Vermont	 United States
Pico	 Azores	 Portugal
Picton	 Antártica Chilena Province	 Chile
Pictou	 Nova Scotia	 Canada
Pierce	Spofford Lake,  New Hampshire	 United States
Pig	 Arkansas	 United States
Pihlajasaari	Helsinki	 Finland
Piirissaar	Lake Peipus	 Estonia
Pike	 Minnesota	 United States
Pileni	Solomon Islands	 Solomon Islands
Pine	 Arkansas	 United States
Pine	 Arkansas	 United States
Pine	 Arkansas	 United States
Pine	Georgian Bay  Ontario	 Canada
Pine	Windy Lake  Ontario	 Canada
Pine	Lake Huron,  Ontario	 Canada
Pine	 Rhode Island	 United States
Pine	 Vermont	 United States
Pine	 Vermont	 United States
Ping Chau	 Hong Kong	 China
Pinto	 Alabama	 United States
Piperi	Northern Sporades	 Greece
Pippin Towhead	 Alabama	 United States
Pirallahı	Baku, Caspian Sea	 Azerbaijan
Pirumeri	Shortland Islands	 Solomon Islands
Piss Pot	South Branch Potomac River,  West Virginia	 United States
Pitcairn	 Pitcairn Islands	 British overseas territories
Isle au Pitre	 Louisiana	 United States
Pitt	 British Columbia	 Canada
Plane Crash	 Arizona	 United States
Plato	 Rhode Island	 United States
Pleasant	 Arkansas	 United States
Pleasant	Georgian Bay  Ontario	 Canada
Pleasure	Sabine Lake,  Texas	 United States
Plum	 Massachusetts	 United States
Plum	 New York	 United States
Plum	Lake Michigan,  Wisconsin	 United States
Plumpudding		 Namibia
Plateia Aiginis	Saronic Islands	 Greece
Poi Toi	Po Toi Islands,  Hong Kong	 China
Poço	Beira Litoral islands	 Portugal
Poel	Baltic Sea	 Germany
Pohnpei	Senyavin Islands, Micronesia	 Federated States of Micronesia
Point au Fer	 Louisiana	 United States
Point of Cedars	 Delaware	 United States
Pollopel	Hudson River,  New York	 United States
Poker Hill	 Arkansas	 United States
Polyaigos	Cyclades	 Greece
Pomham	 Rhode Island	 United States
Pomona		 Namibia
Ponui	Hauraki Gulf	 New Zealand
Ponza	Pontine Islands	 Italy
Pooley	 British Columbia	 Canada
Popasquash	 Vermont	 United States
Popes	New Bedford Harbor,  Massachusetts	 United States
Poplar	Tygart Valley River,  West Virginia	 United States
Porcher	 British Columbia	 Canada
Poros	Saronic Islands	 Greece
Port Hamilton		 South Korea
Port	Islands of Gdańsk	 Poland
Portage	Mississippi River,  Missouri	 United States
Portage	Georgian Bay  Ontario	 Canada
Portage	 Washington	 United States
Portland	British Isles	 United Kingdom
Porto Santo	Madeira Islands	 Portugal
Possession		 Namibia
Potato	Severn Sound  Ontario	 Canada
Potato	 Rhode Island	 United States
Potvin	French River  Ontario	 Canada
Pourewa	Tolaga Bay	 New Zealand
Poveglia	Venice	 Italy
Powell	South Orkney Islands	Claimed by:
 United Kingdom as part of the  Falkland Islands and by
 Argentina
Prairie Point Towhead	Mississippi River,  Arkansas	 United States
Prall's	Arthur Kill,  New York	 United States
Prangli	Gulf of Finland	 Estonia
Premuda	Adriatic Sea	 Croatia
Prescott	 Nunavut	 Canada
Prevlaka	Bay of Kotor Islands	 Montenegro
Price	 British Columbia	 Canada
Price	 Alabama	 United States
Prickley Pear	 Delaware	 United States
Príncipe	Gulf of Guinea	 São Tomé and Príncipe
Prince	 Alabama	 United States
Prince Charles	Queen Elizabeth Islands,  Nunavut	 Canada
Prince Edward	 Prince Edward Island	 Canada
Prince Patrick	 Northwest Territories	 Canada
Prince of Wales	 British Columbia	 Canada
Princess Royal	 British Columbia	 Canada
Prins Karls Forland	Svalbard	 Norway
Procida	Flegree Islands	 Italy
Profit	Mississippi River,  Louisiana	 United States
Protection	 Washington	 United States
Providencia	 San Andrés y Providencia	 Colombia
Providence	 Vermont	 United States
Province	 Vermont	 United States
Prudence	Narragansett Bay,  Rhode Island	 United States
Pruetts	 Alabama	 United States
Pruitt	 Arkansas	 United States
Prvić	Adriatic Sea	 Croatia
Pryor	Ohio River,  Kentucky	 United States
Psara	Greek Archipelago	 Greece
Psathoura	Northern Sporades	 Greece
Pserimos	Dodecanese	 Greece
Psili	Saronic Islands	 Greece
Puerto Rico 	Greater Antilles	 United States
Puffin		 Ireland
Puffin		 Wales
Puffin		 Iceland
Puffin	 Alaska	 United States
Puffin	 Newfoundland and Labrador	 Canada
Puget	Columbia River,  Washington	 United States
Puka-Puka	Disappointment Islands,  Tuamotus,  French Polynesia	 France
Pukapuka	Cook Islands	 New Zealand
Pukarua	 Tuamotus,  French Polynesia	 France
Pulau Adonara	Malay Archipelago	 Indonesia
Pulau Alor	Malay Archipelago	 Indonesia
Pulau Aman	 Penang	 Malaysia
Pulau Atauro	Malay Archipelago	 East Timor
Pulau Besar	 Malacca	 Malaysia
Pulau Besar	 Johor	 Malaysia
Pulau Betong	 Penang	 Malaysia
Pulau Carey	 Selangor	 Malaysia
Pulau Galang	Riau Archipelago	 Indonesia
Pulau Gedung	 Johor	 Malaysia
Pulau Indah	 Selangor	 Malaysia
Pulau Jaco	Malay Archipelago	 East Timor
Pulau Ketam	 Selangor	 Malaysia
Pulau Kisar	Malay Archipelago	 Indonesia
Pulau Klang	 Selangor	 Malaysia
Pulau Kombe	Malay Archipelago	 Indonesia
Pulau Lomblen	Malay Archipelago	 Indonesia
Pulau Melaka	 Malacca	 Malaysia
Pulau Obira	Malay Archipelago	 Indonesia
Pulau Pantar	Malay Archipelago	 Indonesia
Pulau Payar	 Kedah	 Malaysia
Pulau Pemanggil	 Johor	 Malaysia
Pulau Rawa	 Johor	 Malaysia
Pulau Romang	Malay Archipelago	 Indonesia
Pulau Roti	Malay Archipelago	 Indonesia
Pulau Semau	Malay Archipelago	 Indonesia
Pulau Sibu	 Johor	 Malaysia
Pulau Solor	Malay Archipelago	 Indonesia
Pulau Tengah	 Johor	 Malaysia
Pulau Tenggol		 Malaysia
Pulau Tiga	 Sabah	 Malaysia
Pulau Tikus	 Penang	 Malaysia
Pulau Tinggi	 Johor	 Malaysia
Pulau Wetar		 Indonesia
Pullen	 New Jersey	 United States
Puná	Gulf of Guayaquil	 Ecuador
Pulincunnu	Pamba River, Kerala	 India
Psyttaleia	Saronic Islands	 Greece
Pyramid	 Nevada	 United States
Qabre Nakhoda	Persian Gulf	 Iran
Qaruh	Persian Gulf	 Kuwait
Qeshm	Persian Gulf	 Iran
Quadra	Discovery Islands,  British Columbia	 Canada
Quail	Lyttelton Harbour	 New Zealand
Quarry	Severn Sound  Ontario	 Canada
Queneska	 Vermont	 United States
Query	Mikkelsen Bay, Antarctica	
Quilaluia	Quirimbas Archipelago	 Mozambique
Quirimba	Quirimbas Archipelago	 Mozambique
Quisiva	Quirimbas Archipelago	 Mozambique
Quoin	Torres Strait Islands,  Queensland	 Australia
Rab		 Croatia
Rabbit	There are four Rabbit islands in NZ, the best known is in Tasman Bay	 New Zealand
Rabbit	Lower Lough Erne	 Ireland
Rabbit		 Lebanon
Rabbit	Calcasieu Lake,  Louisiana	 United States
Rabbit	Georgian Bay,  Ontario	 Canada
Rabbit	Mississippi River,  Mississippi	 United States
Racoon	 Louisiana	 United States
Ragged	Lake Winnipesaukee,  New Hampshire	 United States
Ragged	 Nunavut	 Canada
Rakino	Hauraki Gulf	 New Zealand
Raiatea	Windward Islands, Society Islands,  French Polynesia	 Overseas Lands of France
Rainsford	Boston Harbor,  Massachusetts	 United States
Raippaluoto	Ostrobothnia	 Finland
Rakahanga	Cook Islands	 Cook Islands
Ram Island	Stonington, Connecticut	 United States
Rambutyo	Admiralty Islands	 Papua New Guinea
Ramea	 Newfoundland and Labrador	 Canada
Ramree		 Myanmar
Ramshead	Lake Mead,  Nevada	 United States
Randall's	East River,  New York	 United States
Randolph	Grand Bay,  New Brunswick	 Canada
Random	 Newfoundland and Labrador	 Canada
Rangiroa	Palliser Islands,  Tuamotus,  French Polynesia	 France
Rangitata	Rangitata River	 New Zealand
Rangitoto	Hauraki Gulf	 New Zealand
Raoul	Kermadec Islands	 New Zealand
Raroia	 Tuamotus,  French Polynesia	 France
Rarotonga	Cook Islands	 Cook Islands
Raspberry	Mississippi River,  Minnesota	 United States
Raspberry	Kodiak Archipelago,  Alaska	 United States
Rat	Rat Islands group of the Aleutian Islands,  Alaska	 United States
Rat	City Island Harbor,  New York	 United States
Rathlin	Northern Ireland	 United Kingdom
Rathlin O'Birne		 Ireland
Rato	Estremadura islands	 Portugal
Ile aux Rats	Cosmoledo atoll	 Seychelles
Rattlesnake	Clear Lake,  California	 United States
Rattlesnake	Okanagan Lake,  British Columbia	 Canada
Rattlesnake	Lake Winnipesaukee,  New Hampshire	 United States
Ravenga	Banks Islands	 Vanuatu
Île de Ré	Pertuis d'Antioche	 France
Reao	 Tuamotus,  French Polynesia	 France
Rearlaplap	Arno Atoll	 Marshall Islands
Rebbenesøy	Karlsøy and Tromsø	 Norway
Ile aux Récifs	Inner Islands	 Seychelles
Reclaimed	Inner Islands	 Seychelles
Red Rock	San Francisco Bay,  California	 United States
Redbud	Susquehanna River,  Pennsylvania	 United States
Redhead	Lake Winnipesaukee,  New Hampshire	 United States
Redman Point Bar	Mississippi River,  Arkansas and  Tennessee	 United States
Redonda	Lesser Antilles	 Antigua and Barbuda
Reedy	Delaware River,  Delaware	 United States
Reichenau	Lake Constance	 Germany
Reindeer	Lake Winnipeg,  Manitoba	 Canada
Reinøya	Karlsøy and Tromsø	 Norway
Rema	Lake Tana	 Ethiopia
Rémire	Amirante Islands	 Seychelles
Renaissance Island	 Aruba	 Kingdom of the Netherlands
René-Levasseur	Manicouagan Reservoir,  Quebec	 Canada
Rennell	Rennell and Bellona Province, Solomon Islands	 Solomon Islands
Rennesøy	Ryfylke Islands, Rogaland	 Norway
Residence	St. Joseph's Atoll	 Seychelles
Resolution	 Nunavut	 Canada
Resolution		 New Zealand
Resource Island	St. Joseph's Atoll	 Seychelles
Revillagigedo	Alexander Archipelago,  Alaska	 United States
Rharbi	Kerkenna Islands	 Tunisia
Rhineia	Cyclades	 Greece
Rhodes	Dodecanese	 Greece
Rice	Lost Lake,  Louisiana	 United States
Rikers	Upper East River,  New York	 United States
Rincah		 Indonesia
Ringvassøy	Karlsøy and Tromsø	 Norway
Ripapa	Lyttelton Harbour	 New Zealand
Roaninish	County Donegal	 Ireland
Roanoke	Outer Banks,  North Carolina	 United States
Roastbeef		 Namibia
Robben	Table Bay	 South Africa
Robert	South Shetland Islands	Claimed by:
Argentine Antarctica,  Argentina,
 Antártica Chilena Province of  Chile, and
 British Antarctic Territory of the United Kingdom
Isla Robertson	South Orkney Islands	Claimed by the: United Kingdom as part of the  Falkland Islands and by
 Argentina
Robertson	Cumberland River,  Tennessee	 United States
Robertson	Tygart Valley River,  West Virginia	 United States
Robins	Peconic Bay,  New York	 United States
Robinson Crusoe	Juan Fernández Islands	 Chile
Roche Babri	Inner Islands	 Seychelles
Roche Bouquet	Inner Islands	 Seychelles
Roche Canon	Inner Islands	 Seychelles
Roche Du Sud	Inner Islands	 Seychelles
Roche Grande Maman	Inner Islands	 Seychelles
Roche Tortue	Inner Islands	 Seychelles
Rocher Des Oiseaux		 Mauritius
Ile Roches		 Mauritius
Rock	Willamette River,  Oregon	 United States
Rock	Green Bay,  Wisconsin	 United States
Rockabill		 Ireland
Rockall	North Atlantic	 United Kingdom
Roderick	 British Columbia	 Canada
Roi-Namur	Kwajalein Atoll, Ralik Chain	 Marshall Islands
Ilhéu das Rólas	Gulf of Guinea	 São Tomé and Príncipe
Rolvsøya		
Rømø	North Frisian Islands	 Germany
Romsø	Great Belt	 Denmark
Île Ronde		 Mauritius
Île Ronde	Inner Islands	 Seychelles
Rondeau	Ohio River,  Kentucky	 United States
Rongelap Atoll	Ralik Chain	 Marshall Islands
Rongerik Atoll	Kwajalein Atoll, Ralik Chain	 Marshall Islands
Roosevelt	East River,  New York	 United States
Rose	Georgian Bay,  Ontario	 Canada
Ross		Antarctica
Ross	Willamette River,  Oregon	 United States
Ross	Allegheny River,  Pennsylvania	 United States
Rosscor	Lower Lough Erne	 Ireland
Røst	Lofoten	 Norway
Rostam	Persian Gulf	 Iran
R. Thompson's	Allegheny River,  Pennsylvania	 United States
Rotoroa	Hauraki Gulf	 New Zealand
Rottumeroog	Eemsmond,  Groningen	 Netherlands
Rottumerplaat	Eemsmond,  Groningen	 Netherlands
Rotuma		 Fiji
Rough	Lower Lough Erne	 Ireland
Rough	Solway Firth	 Scotland
Round	Krenitzin Islands subgroup of the Fox Islands group of the Aleutian Islands,  Alaska	 United States
Round	Straits of Mackinac,  Michigan	 United States
Round	Mississippi Sound,  Mississippi	 United States
Round	Lake Winnipesaukee,  New Hampshire	 United States
Rousay	The North Isles,  Orkney Islands	 Scotland
Rowa	Banks Islands	 Vanuatu
Rowett	South Shetland Islands	Claimed by Argentine Antarctica,  Argentina,  Antártica Chilena Province of  Chile, and  British Antarctic Territory of the United Kingdom
Rowley	Queen Elizabeth Islands,  Nunavut	 Canada
Isle Royale	Lake Superior,  Michigan	 United States
Rozenburg	 South Holland	 Netherlands
Ruapuke		 New Zealand
Rubud Al Gharbiyah	Hawar Islands	 Bahrain
Rubud Al Sharqiyah	Hawar Islands	 Bahrain
Ruden	 Mecklenburg-Vorpommern	 Germany
ostrov Rudolfa	Franz Josef Land	 Russia
Rügen	 Mecklenburg-Vorpommern	 Germany
Rugged	South Shetland Islands	Claimed by Argentine Antarctica,  Argentina,  Antártica Chilena Province of  Chile, and  British Antarctic Territory of the United Kingdom
Ruhnu	Gulf of Riga	 Estonia
Rùm	Small Isles of the Inner Hebrides	 Scotland
Rush	Mississippi River,  Iowa	 United States
Rusk Holm	The North Isles,  Orkney Islands	 Scotland
Russell	Lake Huron  Ontario	 Canada
Russel	 Nunavut	 Canada
Russel	St. Clair River,  Michigan	 United States
Russell[disambiguation needed]	 Queensland	 Australia
Rysa Little	The South Isles, Orkney Islands	 Scotland
Saaremaa	West Estonian Archipelago; Baltic Sea	 Estonia
Saarnaki laid	Väinameri Sea	 Estonia
Saba 	Lesser Antilles	 Netherlands
Cayo Sabinal	Greater Antilles	 Cuba
Sable	 Nova Scotia	 Canada
Sabrina	Balleny Islands	Ross Dependency,  New Zealand
Sabula	 Iowa	 United States
Saddle	South Orkney Islands	Claimed by:
 the United Kingdom as part of the  Falkland Islands and by
 Argentina
Safra	Alentejo islands	 Portugal
Saint Agnes	Isles of Scilly	 United Kingdom
Saint Anastasia	Black Sea	 Bulgaria
Saint Andrews	Admiralty Islands	 Papua New Guinea
Saint-Barthélemy	Lesser Antilles	 France
Saint Catherine	Susquehanna River,  Maryland	 United States
Saint Catherine	Potomac River,  Maryland	 United States
Saint Clement's	Potomac River,  Maryland	 United States
Saint Croix	 United States Virgin Islands, Lesser Antilles	 United States
Saint Croix	Saint Croix River,  Maine	 United States
Saint Cyicus	Black Sea	 Bulgaria
Saint Eustratius		 Greece
Saint George	Potomac River,  Maryland	 United States
Saint Giles	Lesser Antilles	 Trinidad and Tobago
Saint Ivan	Black Sea	 Bulgaria
Saint Helena 		 British overseas territory of  Saint Helena, Ascension and Tristan da Cunha
St. Helena Island (Maryland)	 Maryland	 United States
Saint Helena	Straits of Mackinac,  Michigan	 United States
Saint Helena	Sea Islands,  South Carolina	 United States
Saint Helena	Little Round Bay,  Maryland	 United States
Île Saint-Honorat	Lérins Islands	 France
Saint Helen's	St. Lawrence River,  Quebec	 Canada
Saint John	 United States Virgin Islands, Lesser Antilles	 United States
Saint Johns	Missouri River,  Missouri	 United States
Saint Joseph	 Ontario	 Canada
Saint Kitts	Lesser Antilles	 Saint Kitts and Nevis
Saint Lawrence	Bering Sea,  Alaska	 United States
Saint Lucia	Lesser Antilles	 Saint Lucia
Saint Margaret	Potomac River,  Maryland	 United States
Île Sainte-Marguerite	Lérins Islands	 France
Saint Martin	Lesser Antilles	Divided between:
 France and
 Kingdom of the Netherlands
Saint Martin	Otago Harbour	 New Zealand
Saint Martin's	Isles of Scilly	 United Kingdom
St. Mary's	Isles of Scilly	 United Kingdom
Saint Matthew	Bering Sea,  Alaska	 United States
St. Maurice Towhead	Mississippi River, Louisiana	 United States
Saint Paul	 Nova Scotia	 Canada
Saint Paul	Pribilof Islands,  Alaska	 United States
Île Saint-Paul	 French Southern Territories, Indian Ocean	 France
Saint Peter	Black Sea	 Bulgaria
Saint Pierre	Manokin River,  Maryland	 United States
Saint Simons	 Georgia	 United States
Saint Thomas	 United States Virgin Islands, Lesser Antilles	 United States
Saint Vincent	Lesser Antilles	 Saint Vincent and the Grenadines
Saint Vincent	 Florida	 United States
Sakhalin	North Pacific,  Sakhalin Oblast	 Russia
Salamina	Saronic Islands	 Greece
Salawati	Raja Ampat Islands	 Indonesia
Salina	Aeolian Islands	 Italy
Salisbury	 Nunavut	 Canada
Salsette	Maharashtra	 India
Saltholm	Oresund	 Denmark/ Sweden
Saltspring	Gulf Islands,  British Columbia	 Canada
Samalga	Fox Islands group of the Aleutian Islands,  Alaska	 United States
Samar	Visayas	 Philippines
Samhah	Socotra	 Yemen
Samos Island	Beira Litoral Islands	 Portugal
Samos	Dodecanese	 Greece
Samothraki		 Greece
Samphrey	 Shetland Islands	 Scotland
Sampson	Pleasant Bay, Cape Cod,  Massachusetts	 United States
Samsø	Kattegat	 Denmark
Samson	Isles of Scilly	 United Kingdom
San Andrés	 San Andrés y Providencia	 Colombia
San Benedicto	Revillagigedo Islands,  Colima	 Mexico
San Benitos		 Mexico
San Clemente Island	Channel Islands of California,  California	 United States
San Cristobal	Solomon Islands	 Solomon Islands
San José	 Baja California Sur	 Mexico
San Jose	 Texas	 United States
San Juan	San Juan Islands,  Washington	 United States
San Martiño	 Galicia	 Spain
San Miguel	Channel Islands of California,  California	 United States
San Nicolas	Channel Islands of California,  California	 United States
San Pietro	 Sardinia	 Italy
San Salvador	The Bahamas	 Bahamas
Sanak	Sanak Islands, Gulf of Alaska,  Alaska	 United States
Sand Cay	Spratley Islands	Disputed between:
 China,
 Republic of China,
 Vietnam,
 Brunei,
 Philippines, and
 Malaysia
Sand	Ohio River,  Kentucky	 United States
Sand	 Hawaii	 United States
Sanday	The North Isles,  Orkney Islands	 Scotland
Sandoy	 Faroe Islands	 Denmark
Sandy	Georgian Bay,  Ontario	 Canada
Sandy	Nanticoke River,  Maryland	 United States
Sandy Point	 Newfoundland and Labrador	 Canada
Sandy Point	Sinepuxent Bay,  Maryland	 United States
Sannak	Fox Islands group of the Aleutian Islands,  Alaska	 United States
Sans Souci	Georgian Bay  Ontario	 Canada
Santa Ana	Solomon Islands	 Solomon Islands
Santa Barbara	Channel Islands of California,  California	 United States
Santa Catalina	Channel Islands of California,  California	 United States
Santa Clara	Juan Fernández archipelago, Chile	 Chile
Santa Cruz	Channel Islands of California,  California	 United States
Santa Isabel	Solomon Islands	 Solomon Islands
Santa Margarita	 Baja California Sur	 Mexico
Santa Maria	 Azores	 Portugal
Santa Rosa	Channel Islands of California,  California	 United States
Santa Rosa	 Florida	 United States
Santorini	Cyclades	 Greece
São Brás	Alentejo islands	 Portugal
São Jorge	 Azores	 Portugal
São Miguel	 Azores	 Portugal
São Tomé	Gulf of Guinea	 São Tomé and Príncipe
Saona Island	Antilles	 Dominican Republic
Sardinia 		 Italy
Saria		 Greece
Sark 	Channel Islands	 Guernsey
Saturna	Gulf Islands,  British Columbia	 Canada
Saunders	 Falkland Islands	 United Kingdom
Sauvie	Columbia River,  Oregon	 United States
Savage	Near Islands group of the Aleutian Islands,  Alaska	 United States
Savai'i	Samoan Islands	 Samoa
Savary	Georgia Straight,  British Columbia	 Canada
Sawyer	Mississippi River, Minnesota	 United States
Sazan	Bay of Vlorë	 Albania
Scarecrow	 Michigan	 United States
Scharhörn	North Sea	 Germany
Schiermonnikoog	West Frisian Islands	 Netherlands
Schmidt	Severnaya Zemlya, Krasnoyarsk Krai	 Russia
Schoinoussa	Cyclades	 Greece
School	Platte River,  Nebraska	 United States
Schouwen-Duiveland	 Zeeland	 Netherlands
Scilly	Windward Islands, Society Islands,  French Polynesia	 Overseas Lands of France
Scott		Ross Dependency,  New Zealand
Scott	Potomac River,  Maryland	 United States
Scotts	Kanawha River,  West Virginia	 United States
Scout	Tygart Valley River,  West Virginia	 United States
Sea	Fraser River,  British Columbia	 Canada
Seal	South Shetland Islands	Claimed by:
Argentine Antarctica,  Argentina,
 Antártica Chilena Province of  Chile, and
 British Antarctic Territory of the United Kingdom
Sealion	 Falkland Islands	 United Kingdom
Sebatik	 Sabah	 Indonesia and  Malaysia
Secretary		 New Zealand
Sedanka	Fox Islands group of the Aleutian Islands,  Alaska	 United States
Seguam	Andreanof Islands group of the Aleutian Islands,  Alaska	 United States
Segula	Rat Islands group of the Aleutian Islands,  Alaska	 United States
Seil	Slate Islands of the Inner Hebrides	 Scotland
Seiland	Finnmark	 Norway
Île de Sein	Atlantic Ocean	 France
Sejerø	Kattegat	 Denmark
Selaön	Lake Mälaren	 Sweden
Selden	Potomac River,  Maryland	 United States
Selvagem Grande	Savage Islands group of the  Madeira Islands	 Portugal
Selvagem Pequena	Savage Islands group of the  Madeira Islands	 Portugal
Semisopochnoi	Rat Islands group of the Aleutian Islands,  Alaska	 United States
Semyonovsky	New Siberian Islands	 Russia
Senja	Troms	 Norway
Serifos	Cyclades	 Greece
Seven	Cheat River,  West Virginia	 United States
Seven Mile	Jersey Shore,  New Jersey	 United States
Severny	Novaya Zemlya, Arkhangelsk Oblast	 Russia
Shackleford	 North Carolina	 United States
Shanaghy	Upper Lough Erne	 Ireland
Shandrew	Mississippi River,  Illinois	 United States
Shapinsay	The North Isles,  Orkney Islands	 Scotland
Sharp	Georgian Bay,  Ontario	 Canada
Sharp		 Hong Kong
Sharpes	Chesapeake Bay,  Maryland	 United States
Swan	Chesapeake Bay,  Maryland	 United States
Sharpshin	Potomac River,  Maryland	 United States
Shatvar	Persian Gulf	 Iran
Shaw	San Juan Islands,  Washington	 United States
Shawanaga	Georgian Bay,  Ontario	 Canada
Sheek's	St. Lawrence Seaway,  Ontario	 Canada
Shell		 Wales
Shell	 Florida	 United States
Shell	 Louisiana	 United States
Shelldrake	Brockanorton Bay,  Maryland	 United States
Shemya	Semichi Islands cluster in the Near Islands group of the Aleutian Islands,  Alaska	 United States
Shengshan	Zhoushan Archipelago	 China
Shenick		 Ireland
Shepherds	Potomac River,  Maryland	 United States
Sherbo	Atlantic Ocean	 Sierra Leone
Sherkin	Islands of Roaringwater Bay, County Cork	 Ireland
Sherose	 Nova Scotia	 Canada
Sherwin	Potomac River,  Maryland	 United States
Shiashkotan	Kuril Islands,  Sakhalin Oblast	 Russia
Shif	Persian Gulf	 Iran
Shikinejima	Izu Islands	 Japan
Shikoku	Japanese archipelago	 Japan
Shikotan	Kuril Islands,  Sakhalin Oblast	 Russia, claimed by  Japan
Shimoji	Miyako Islands part of the Sakishima Islands part of the Ryukyu Islands	 Japan
Ship	Gulf Coast,  Mississippi	 United States
Ship	 Newfoundland and Labrador	 Canada
Shippingport	Ohio River,  Kentucky	 United States
Shoe	Beaver Island archipelago, Lake Michigan,  Michigan	 United States
Shomali	Persian Gulf	 Iran
Shooters	Newark Bay,  New Jersey	 United States
Shortland	Shortland Islands	 Solomon Islands
Shreves Bar	Mississippi River, Louisiana	 United States
Shumshu	Kuril Islands,  Sakhalin Oblast	 Russia
Shuna	Slate Islands	 Scotland
Shuwaikh	Kuwait Bay	 Kuwait
Sicily 		 Italy
Sido		 South Korea
Sifnos	Cyclades	 Greece
Signy	South Orkney Islands	Claimed by the United Kingdom as part of the  Falkland Islands and by  Argentina
Sijiao Island	Zhoushan Archipelago	 China
Sikaiana	Solomon Islands	 Solomon Islands
Sikinos	Cyclades	 Greece
Silba	Adriatic Sea	 Croatia
Silmido	Yellow Sea	 South Korea
Simushir	Kuril Islands,  Sakhalin Oblast	 Russia
Sinclair	Great Barrier Reef,  Queensland	 Australia
Sinclair's Island		 Namibia
Sin Cowe	Spratley Islands	Disputed between:
 China,
 Republic of China,
 Vietnam,
 Brunei,
 Philippines, and
 Malaysia
Sindo	Yellow Sea	 South Korea
Singapore		 Singapore
Sinjido		 South Korea
Sint Eustatius 	Lesser Antilles	 Netherlands
Siø	Islands of the waters south of Funen	 Denmark
Šipan	Elaphiti Islands	 Croatia
Sipson	Pleasant Bay, Cape Cod,  Massachusetts	 United States
Sipson Meadow	Pleasant Bay, Cape Cod,  Massachusetts	 United States
Sir Bani Yas	Persian Gulf	 United Arab Emirates
Sirri	Persian Gulf	 Iran
Sitrah	Persian Gulf	 Bahrain
Siu A Chau	Soko Islands,  Hong Kong	 China
Sixmile	Allegheny River  Pennsylvania	 United States
Sixmile	Ohio River,  Kentucky	 United States
Sjaelland		 Denmark
Sjumansholmen	Southern Gothenburg Archipelago	 Sweden
Skantzoura	Sporades	 Greece
Skarø	Islands of the waters south of Funen	 Denmark
Skellig Michael	Skellig Islands	 Ireland
Skiathos	Sporades	 Greece
Skogerøy		 Norway
Skopelos	Sporades	 Greece
Skraeling	 Nunavut	 Canada
Skull	 British Columbia	 Canada
Skúvoy	 Faroe Islands	 Denmark
Isle of Skye	Inner Hebrides	 Scotland
Skyros	Sporades	 Greece
Slate	Slate Islands, Lake Superior,  Ontario	 Canada
Slim	Mississippi River,  Missouri	 United States
Slim	Ohio River,  Kentucky	 United States
Slipper		 New Zealand
Slotsholmen	Copenhagen Harbour	 Denmark
Smaller Bent	Persian Gulf	 Iran
Smaojlovich	Sedov Archipelago of Severnaya Zemlya, Krasnoyarsk Krai	 Russia
Smith	Chesapeake Bay,  Maryland	 United States
Smith	San Juan Islands,  Washington	 United States
Smith	South Shetland Islands	Claimed by:
Argentine Antarctica,  Argentina,
 Antártica Chilena Province of  Chile, and
 British Antarctic Territory of the United Kingdom
Smith	Kankakee River,  Illinois	 United States
Smokehouse	Lake Huron,  Ontario	 Canada
Smøla		 Norway
Smooth	Georgian Bay,  Ontario	 Canada
Snake	Black Sea	 Ukraine
Snake	Lake Simcoe,  Ontario	 Canada
Snake	Saint Lawrence River,  Ontario	 Canada
Snake	Fishing Bay,  Maryland	 United States
Snake	Patuxent River,  Maryland	 United States
Snake	Potomac River,  Maryland	 United States
Snake	Susquehanna River,  Maryland	 United States
Snake	Georgian Bay,  Ontario	 Canada
Snape	Belcher Islands group in Hudson Bay,  Nunavut	 Canada
Snow	South Shetland Islands	Claimed by:
Argentine Antarctica,  Argentina,
 Antártica Chilena Province of  Chile, and
 British Antarctic Territory of the United Kingdom
Soay	Inner Hebrides	 Scotland
Soay	St. Kilda group of the Outer Hebrides	 Scotland
Sobieszewo	Islands of Gdańsk	 Poland
Sodo	Port Hamilton	 South Korea
Solomons	Patuxent River,  Maryland	 United States
Solomons Lump	Kedges Straits,  Maryland	 United States
Socorro	Revillagigedo Islands,  Colima	 Mexico
Socotra	Socotra	 Yemen
Solovetsky	Solovetsky Islands	 Russia
Šolta	Adriatic Sea	 Croatia
Somerset	 Bermuda	 United Kingdom
Somerset	 Nunavut	 Canada
Sondre Kvaløy		 Norway
Sonora	 British Columbia	 Canada
Sørøya	Finnmark	 Norway
Sotra	Hordaland	 Norway
Sound Gruney	 Shetland Islands	 Scotland
South	Jason Islands of the  Falkland Islands	 United Kingdom
South		 New Zealand
South Bass	Bass Islands,  Ohio	 United States
South Beach	Cape Cod,  Massachusetts	 United States
South Brother	Andaman Archipelago, Indian Ocean	 India
South Brother	East River,  New York	 United States
South Brother	Chagos Archipelago, Indian Ocean	 United Kingdom
South Brother	Atlantic Ocean,  Connecticut	 United States
South Brother	Seven Brothers, Bab-el-Mandeb	 Djibouti
South Hammocks	Assawoman Bay,  Maryland	 United States
South Havre	 Shetland Islands	 Scotland
South Isle of Gletness	 Shetland Islands	 Scotland
South Limestone	Georgian Bay  Ontario	 Canada
South Long		
South Manitou	Lake Michigan,  Michigan	 United States
South Marsh	Chesapeake Bay,  Maryland	 United States
South Monomoy	Cape Cod,  Massachusetts	 United States
South Padre	 Texas	 United States
South Ronaldsay	The South Isles,  Orkney Islands	 Scotland
South Uist	Outer Hebrides	 Scotland
South Watcher	Georgian Bay,  Ontario	 Canada
Southampton	 Nunavut	 Canada
Southwest Cay	Spratley Islands	Disputed between:
 China,
 Republic of China,
 Vietnam,
 Brunei,
 Philippines, and
 Malaysia
Spectacle	Boston Harbor,  Massachusetts	 United States
Speedwell	 Falkland Islands	 United Kingdom
Spencer	Susquehanna River,  Maryland	 United States
Spencer	Susquehanna River,  Maryland	 United States
Spencer's	 Nova Scotia	 Canada
Sponge Bar	Willamette River,  Oregon	 United States
Spriggs	Blackwater River,  Maryland	 United States
Spring	Holland Straits,  Maryland	 United States
Spesutie	Chesapeake Bay,  Maryland	 United States
Spetses	Saronic Islands	 Greece
Spieden	San Juan Islands,  Washington	 United States
Spiekeroog	East Frisian Islands	 Germany
Spirit	Maligne Lake,  Alberta	 Canada
Spitsbergen	Svalbard	 Norway
Sport-sziget	Danube River	 Hungary
Split	Belcher Islands, Hudson Bay,  Nunavut	 Canada
Spratly	Spratley Islands	Disputed between:
 China,
 Republic of China,
 Vietnam,
 Brunei,
 Philippines, and
 Malaysia
Sprogø	Great Belt	 Denmark
Spry	Chesapeake Bay,  Maryland	 United States
Square	 Newfoundland and Labrador	 Canada
Srednij	Sedov Archipelago of Severnaya Zemlya, Krasnoyarsk Krai	 Russia
Sri Lanka		 Sri Lanka
Ssese	Lake Victoria	 Uganda
Staats	 Falkland Islands	 United Kingdom
Stack	Mississippi River, Mississippi	 United States
Stag	St. Clair River,  Ontario	 Canada
Stags of Broadhaven		 Ireland
Stall Hill	Lake Rico,  Massachusetts	 United States
Stansbury	Great Salt Lake,  Utah	 United States
Star	Isles of Shoals,  New Hampshire	 United States
Starbuck	Line Islands	 Kiribati
Starbuck	Hudson River,  New York	 United States
Starve	Lake Erie,  Ohio	 United States
Staten	 New York	 United States
Stefansson	 Nunavut	 Canada
Stephens	Marlborough Sounds	 New Zealand
Stevens	Lake Huron,  Ontario	 Canada
Stevens	 Massachusetts	 United States
Stewart		 New Zealand
Stewart	Ohio River,  Kentucky	 United States
Steels	Susquehanna River,  Maryland	 United States
Steeple	Jason Islands of the  Falkland Islands	 United Kingdom
Sterrett	Susquehanna River,  Maryland	 United States
Steves	Chincoteague Bay,  Maryland	 United States
Stingaree	Blackwater River,  Maryland	 United States
Stjernøy		 Norway
Stolbnyi	Lake Seliger, Tver Oblast	 Russia
Stolbovoy	New Siberian Islands	 Russia
Stoltenhoff	Nightingale Islands,  Tristan da Cunha	 British Overseas Territory of  Saint Helena
Stóra Dímun	 Faroe Islands	 Denmark
Stora Förö	Southern Gothenburg Archipelago	 Sweden
Stor	 Nunavut	 Canada
Stora Karlsö	Baltic Sea	 Sweden
Stord	Hordaland	 Norway
Streymoy	 Faroe Islands	 Denmark
Stromboli	Aeolian Islands	 Italy
Strong	Pleasant Bay, Cape Cod,  Massachusetts	 United States
Stronsay	The North Isles,  Orkney Islands	 Scotland
Strynø		 Denmark
Stuart	Discovery Islands,  British Columbia	 Canada
Stuart	San Juan Islands,  Washington	 United States
Stucker	Susquehanna River,  Pennsylvania	 United States
Sturge	Balleny Islands	Ross Dependency,  New Zealand
Styrsö	Southern Gothenburg Archipelago	 Sweden
Suakin Archipelago		 Sudan
Sucia	San Juan Islands,  Washington	 United States
Süderoog	North Frisian Islands	 Germany
Südfall	North Frisian Islands	 Germany
Sue	Middle River,  Maryland	 United States
Sugar	Illinois River,  Illinois	 United States
Sugar	 Michigan	 United States
Sula	Møre og Romsdal	 Norway
Sula Sgeir	British Isles	 Scotland
Sulawesi		 Indonesia
Sumatra		 Indonesia
Sunhodo	Port Hamilton	 South Korea
Suomenlinna	Gulf of Finland	 Finland
Suðuroy	 Faroe Islands	 Denmark
Surtsey	Vestmannaeyjar	 Iceland
Susak	Adriatic Sea	 Croatia
Sutwik	 Alaska	 United States
Suur-Pakri	Pakri Islands	 Estonia
Suvorov	Cook Islands	 Cook Islands
Suwad Al Janubiyah	Hawar Islands	 Bahrain
Suwad Al Shamaliyah	Hawar Islands	 Bahrain
Suwanosejima	Tokara Islands part of the Satsunan Islands part of the Ryukyu Islands	 Japan
Suwarrow	Cook Islands	 Cook Islands
Svartsjölandet	Lake Mälaren	 Sweden
Sveaborg	Gulf of Finland	 Finland
Sveta Neđelja	Adriatic Sea	 Montenegro
Sveti Andrija	Elaphiti Islands	 Croatia
Sveti Đorđe	Bay of Kotor Islands	 Montenegro
Sveti Grgur	Adriatic Sea	 Croatia
Sveti Marko	Bay of Kotor Islands	 Montenegro
Sveti Nikola	Adriatic Sea	 Montenegro
Sveti Stefan	Adriatic Sea	 Montenegro
Svínoy	 Faroe Islands	 Denmark
Swains	Tokelau chain,  American Samoa	 United States
Swainson	Potomac River,  Maryland	 United States
Swan	Blackwater River,  Maryland	 United States
Swan	Chesapeake Bay,  Maryland	 United States
Swan		 Honduras
Swans	 Maine	 United States
Sweyn Holm	The North Isles,  Orkney Islands	 Scotland
Swindle	 British Columbia	 Canada
Switha	The South Isles,  Orkney Islands	 Scotland
Swona	The South Isles,  Orkney Islands	 Scotland
Sycamore	Potomac River,  Maryland	 United States
Sycamore	Allegheny River,  Pennsylvania	 United States
Sylt	North Frisian Islands	 Germany
Symi	Dodecanese	 Greece
Syrna	Dodecanese	 Greece
Syros	Cyclades	 Greece
Szalki-sziget	Danube River	 Hungary
Szentendrei-sziget	Danube River	 Hungary
Szúnyog-sziget	Danube River	 Hungary
Tabuaeran	Line Islands	 Kiribati
Tafahoi	Niua group	 Tonga
Tahaa	Windward Islands, Society Islands,  French Polynesia	 Overseas Lands of France
Tahanea	 Tuamotus,  French Polynesia	 France
Tahifehifa	Vava'u group	 Tonga
Tahiti	Windward Islands,  French Polynesia	 Overseas Lands of France
Tai A Chau	Soko Islands,  Hong Kong	 China
Tairajima	Tokara Islands part of the Satsunan Islands part of the Ryukyu Islands	 Japan
Taisho-jima	Senkaku Islands	Administered by
 Japan,
Claimed by:
 China and
 Republic of China
Taiwan		 Republic of China
Takarajima	Tokara Islands part of the Satsunan Islands part of the Ryukyu Islands	 Japan
Takapoto	King George Islands,  Tuamotus,  French Polynesia	 France
Takaroa	King George Islands,  Tuamotus,  French Polynesia	 France
Taketomi	Yaeyama Islands part of the Sakishima Islands part of the Ryukyu Islands	 Japan
Takutea	Cook Islands	 Cook Islands
Takuu	Papua New Guinea, Melanesia	 Papua New Guinea
Talakite	Tongatapu group	 Tonga
Talaud		 Indonesia
Tana Qirqos	Lake Tana	 Ethiopia
Tanegashima	Osumi Islands part of the Satsunan Islands part of the Ryukyu Islands	 Japan
Tanna	Pacific Ocean	 Vanuatu
Tanvat Island	Georgian Bay  Ontario	 Canada
Taohua	Zhoushan Archipelago	 China
Tap Mun	 Hong Kong	 China
Tarama	Miyako Islands part of the Sakishima Islands part of the Ryukyu Islands	 Japan
Tarout	Persian Gulf	 Saudi Arabia
Tåsinge	Islands south of Funen	 Denmark
Tasmania 		 Australia
Tau	Tongatapu group	 Tonga
Tau	'Otu Mu'omu'a group of the Ha'apai group	 Tonga
Taula	Vava'u group	 Tonga
Taunga	Vava'u group	 Tonga
Tautra	Trondheimsfjord	 Norway
Tavira	Algarve islands	 Portugal
Tavolara	 Sardinia	 Italy
Tawhiti Rahi	Poor Knights Islands	 New Zealand
Tearaght	Blasket Islands	 Ireland
Teaupa	Lulunga archipelago of the Ha'apai group	 Tonga
Tegua	Torres Islands	 Vanuatu
Tele-ki-Vava'u	'Otu Mu'omu'a group of the Ha'apai group	 Tonga
Tele-ki-Tonga	'Otu Mu'omu'a group of the Ha'apai group	 Tonga
Telendos	Dodecanese	 Greece
Tematangi	 Tuamotus,  French Polynesia	 France
Tenararo	Acteon Group,  Tuamotus,  French Polynesia	 France
Tenarunga	Acteon Group,  Tuamotus,  French Polynesia	 France
Tenerife	 Canary Islands	 Spain
Tepoto	Disappointment Islands,  Tuamotus,  French Polynesia	 France
Tepoto	Raeffsky Islands,  Tuamotus,  French Polynesia	 France
Teraina	Line Islands	 Kiribati
Terceira	 Azores	 Portugal
Terre-de-Bas	 Guadeloupe, Lesser Antilles	 France
Terre-de-Haut	 Guadeloupe, Lesser Antilles	 France
Terschelling	West Frisian Islands,  Friesland	 Netherlands
Testáda	Beira Litoral Islands	 Portugal
Tetiaroa	Windward Islands,  French Polynesia	 Overseas Lands of France
Texada	Gulf Islands,  British Columbia	 Canada
Texel	West Frisian Islands,  North Holland	 Netherlands
Thanet	British Isles	 United Kingdom
Thassos	Aegean Sea	 Greece
The Lake Isle of Innisfree	Lough Gill	 Ireland
Thetis	Gulf Islands,  British Columbia	 Canada
Thibault	Lake Huron,  Ontario	 Canada
Thief Neck	Watts Bar Lake,  Tennessee	 United States
Thirasia	Cyclades	 Greece
Thirty Thousand	Georgian Bay,  Ontario	 Canada
Thitu	Spratley Islands	Disputed between:
 China,
 Republic of China,
 Vietnam,
 Brunei,
 Philippines, and
 Malaysia
Thompson's	Allegheny River,  Pennsylvania	 United States
Tholen	 Zeeland	 Netherlands
Thousand	Saint Lawrence River, Split between:
 New York and  Ontario	Split between:  United States
and  Canada
Thousand		 Indonesia
Three Mile	 Pennsylvania	 United States
Thurø	Islands south of Funen	 Denmark
Thymaina		 Greece
Tiburón	 Sonora	 Mexico
Tiengemeten	 South Holland	 Netherlands
Tiger	 Louisiana	 United States
Tikehau	 Tuamotus,  French Polynesia	 France
Tikei	King George Islands,  Tuamotus,  French Polynesia	 France
Tikopia	Santa Cruz Islands	 Solomon Islands
Tilos	Dodecanese	 Greece
Timbalier	Timbalier Bay, Louisiana	 United States
Timor	Malay Archipelago	Split Between  East Timor and  Indonesia
Tinhosa Grande	Gulf of Guinea	 São Tomé and Príncipe
Tinhosa Pequena	Gulf of Guinea	 São Tomé and Príncipe
Tini Heke	The Snares	 New Zealand
Tinos	Cyclades	 Greece
Tiree	Inner Hebrides	 Scotland
Tiritiri Matangi	Hauraki Gulf	 New Zealand
Titi	Muttonbird Islands	 New Zealand
Tjeldøya	Vesterålen, Nordland	 Norway
Tjörn	Bohuslän	 Sweden
Toau	Palliser Islands,  Tuamotus,  French Polynesia	 France
Tofua	Lifuka group of the Ha'apai group	 Tonga
Toga	Torres Islands	 Vanuatu
Togo	Mississippi River, Louisiana	 United States
Tokashikijima	Kerama Islands part of the Okinawa Islands part of the Ryukyu Islands	 Japan
Tokelau 		 New Zealand
Toketoke	Tongatapu group	 Tonga
Toku	Vava'u group	 Tonga
Tokulu	Lulunga archipelago of the Ha'apai group	 Tonga
Tokunoshima	Amami Islands part of the Satsunan Islands part of the Ryukyu Islands	 Japan
Tomek Island 2	Platte River,  Nebraska	 United States
Tonches	Georgian Bay,  Ontario	 Canada
Tong	Admiralty Islands	 Papua New Guinea
Tongareva	Cook Islands	 Cook Islands
Tongariki	Shepherd Islands	 Vanuatu
Tongatapu	Tongatapu group	 Tonga
Tongoa	Shepherd Islands	 Vanuatu
Tonregee Island	Upper Lough Erne	 Ireland
Tonumea	'Otu Mu'omu'a group of the Ha'apai group	 Tonga
Toothaker	Mooselookmeguntic Lake,  Maine	 United States
Torcello	Venetian Lagoon	 Italy
Toronto	Lake Ontario,  Ontario	 Canada
Torsö	Lake Vänern	 Sweden
Tortuga		 Haiti
Tory		 Ireland
Toshima	Izu Islands	 Japan
Tosterön-Aspön		 Sweden
Totokafonua	Vava'u group	 Tonga
Totokamaka	Vava'u group	 Tonga
Townhead	Ohio River,  Kentucky	 United States
Traanish	Upper Lough Erne	 Ireland
Tranqueira	Beira Litoral islands	 Portugal
Trasna Island	Lower Lough Erne	 Ireland
Treasure	Ussuri River	 China
Treasure	San Francisco Bay,  California	 United States
Treasure	Lake McKellar,  Tennessee	 United States
Treasure	Puget Sound,  Washington	 United States
Treat	Illinois River,  Illinois	 United States
Três Postes	Beira Baixa islands	 Portugal
Tresco	Isles of Scilly	 United Kingdom
Trinidad	Lesser Antilles	 Trinidad and Tobago
Tristan da Cunha 	Tristan da Cunha Archipelago	 British overseas territory of  Saint Helena, Ascension and Tristan da Cunha
Trodely Island	 Nunavut	 Canada
Trzcinice	Oder Lagoon islands	 Poland
Tsing Yi	 Hong Kong	 China
Tsushima		 Japan
Tue'ia	Vava'u group	 Tonga
Tufuka	Tongatapu group	 Tonga
Tulie	Vava'u group	 Tonga
Tullu Gudo	Lake Zway	 Ethiopia
Tully	Mississippi River,  Illinois	 United States
Tung Lung Chau	 Hong Kong	 China
Tungua	Lulunga archipelago of the Ha'apai group	 Tonga
Tunica	Mississippi River, Louisiana	 United States
Tunø	Kattegat	 Denmark
Tupai	Windward Islands, Society Islands,  French Polynesia	 Overseas Lands of France
Turbina	Beira Litoral Islands	 Portugal
Tureia	 Tuamotus,  French Polynesia	 France
Turkey	Rock River,  Illinois	 United States
Turtle	Tawi-Tawi	 Philippines
Tutu	Arno Atoll	 Marshall Islands
Tuvalu		 Tuvalu
Tu'ungasika	Vava'u group	 Tonga
Twelevemile	Mobile River,  Alabama	 United States
Twelve Mile	Illinois River,  Illinois	 United States
Twelve Mile	Ohio River,  Kentucky	 United States
Twelve Mile	Allegheny River, Pennsylvania	 United States
Two Branch	Mississippi River,  Missouri	 United States
Tysnes	Hordaland	 Norway
Tyson	Lake Huron,  Ontario	 Canada
U Thant	 New York	 United States
Uncatena	Elizabeth Islands,  Massachusetts	 United States
Ugljan	Adriatic Sea	 Croatia
Ujae Atoll	Ralik Chain	 Marshall Islands
Ujelang Atoll	Ralik Chain	 Marshall Islands
Ukeshima	Amami Islands part of the Satsunan Islands part of the Ryukyu Islands	 Japan
Ulva	Paterson Inlet, Stewart Island	 New Zealand
Umbrella	Georgian Bay,  Ontario	 Canada
Umm al Maradim	Persian Gulf	 Kuwait
Umm al-Na'san	Persian Gulf	 Bahrain
Umm an Namil	Persian Gulf	 Kuwait
Umm Hazwarah	Hawar Islands	 Bahrain
Umm Jinni	Hawar Islands	 Bahrain
Unea	Vitu Islands	 Papua New Guinea
Unije	Cres-Lošinj archipelago	 Croatia
Union	Grenadines of the Lesser Antilles	 Saint Vincent and the Grenadines
Unst	 Shetland Islands	 Scotland
Uotsuri-jima	Senkaku Islands part of the Sakishima Islands part of the Ryukyu Islands	Administered by  Japan, Claimed by  China and the  Republic of China
Upper Grey Cloud	 Minnesota	 United States
Upper Panther	 Arkansas	 United States
Upper Twin	Ohio River,  West Virginia	 United States
Uréparapara	Banks Islands	 Vanuatu
Urie Lingey	 Shetland Islands	 Scotland
Urup	Kuril Islands,  Sakhalin Oblast	 Russia
Usedom	Baltic Sea	 Germany and  Poland
Ushishir	Kuril Islands,  Sakhalin Oblast	 Russia
Ushkan	Lake Baikal, Siberia	 Russia
Ustica	 Sicily	 Italy
Utirik Atoll	Ratak Chain	 Marshall Islands
Utsira	Haugesund, Rogaland	 Norway
Uyea	 Shetland Islands	 Scotland
Uynarey	 Shetland Islands	 Scotland
Väddö och Björkö		 Sweden
Værøy	Lofoten, Nordland	 Norway
Vágar	 Faroe Islands	 Denmark
Vahanga	Acteon Group,  Tuamotus,  French Polynesia	 Overseas collectivity of France
Vahitahi	Tuamotu Archipelago,  French Polynesia	 Overseas collectivity of France
Väike-Pakri	Pakri Islands	 Estonia
Vaila	 Shetland Islands	 Scotland
Île aux Vainqueurs	 Saint-Pierre and Miquelon	 Overseas collectivity of France
Vairaatea	Tuamotu Archipelago,  French Polynesia	 Overseas collectivity of France
Valcour	Lake Champlain,  New York	 United States
Valdes	Gulf Islands,  British Columbia	 Canada
Valentia		 Ireland
Île Valhuec	Morbihan,  Bretagne	 France
Vanavana	Tuamotu Archipelago,  French Polynesia	 France
Vancouver	 British Columbia	 Canada
Vandruff	Rock River,  Illinois	 United States
Vannøy	Karlsøy	 Norway
Vanua Lava	Banks Islands	 Vanuatu
Vardim	Danube River	 Bulgaria
Vargö	Southern Gothenburg Archipelago	 Sweden
Värmdön	Stockholm archipelago	 Sweden
Vassøy	Øyane archipelago, Stavanger municipality	 Norway
Vega	The Vega Archipelago, Nordland	 Norway
Vejrø	North of Lolland	 Denmark
Vementry	 Shetland Islands	 Scotland
Vendsyssel-Thy	Jutland Peninsula	 Denmark
Ventotene	Pontine Islands	 Italy
Veránka-sziget	Danube River	 Hungary
Verde	Ribatejo islands	 Portugal
Île Verdelet	Sept Îles,  Bretagne	 France
Île Verte	 Saint-Pierre and Miquelon	 Overseas collectivity of France
Île Verte	Îles des Embiez (La Ciotat)	 France
Île Verte	Gironde estuary	 France
Île Verte	Archipel de Molène,  Bretagne	 France
Île Verte	Peros Banhos, Chagos Archipelago	British Indian Ocean Territory
Île Verte [1]	Gulf of Saint Lawrence,  Quebec	 Canada
Vestvågøy	Lofoten, Nordland	 Norway
Vétaounde	Banks Islands	 Vanuatu
Victoria	 Nunavut	 Canada
Victoria	Lagos	 Nigeria
Viðoy	 Faroe Islands	 Denmark
Vikna	Lofoten, Nord-Trøndelag	 Norway
Vilm	Baltic Sea	 Germany
Vilsandi	Baltic Sea	 Estonia
Vimy	Lake Huron,  Ontario	 Canada
Île Violette	Kerguelen Islands,  French Southern and Antarctic Lands	 France
Vis	Adriatic Sea	 Croatia
Visingsö	Lake Vättern	 Sweden
Vivara	Flegree Islands	 Italy
Vivian Island	 Nunavut	 Canada
Vlieland	West Frisian Islands	 Netherlands
Vohilaid	Väinameri Sea	 Estonia
Voorne-Putten	 South Holland	 Netherlands
Vormsi	West Estonian archipelago; Baltic Sea	 Estonia
Vostok	Line Islands	 Kiribati
Ostrov Vrangelya	Chukotka Autonomous Okrug	 Russia
Vrångö	Southern Gothenburg Archipelago	 Sweden
Vulcano	Aeolian Islands	 Italy
Wabash	Ohio River,  Kentucky	 United States
Waderick Wells Cay	Bahamas	 Bahamas
Wades	Potomac River,  Maryland	 United States
Wadmalaw	 South Carolina	 United States
Waglan	Po Toi Islands,  Hong Kong	 China
Waigeo	Raja Ampat Islands	 Indonesia
Waiheke	Hauraki Gulf	 New Zealand
Wakde	Papua	 Indonesia
Wake	Wake Island, Pacific Ocean	 United States
Wakenaam	Essequibo River	 Guyana
Walcheren	 Zeeland	 Netherlands
Waldron	San Juan Islands,  Washington	 United States
Wales	 Nunavut	 Canada
Walfisch	Bay of Wismar  Mecklenburg-Vorpommern	 Germany
Walker Cay	Bahamas	 Bahamas
Walkers	Horseshoe Lake,  Illinois	 United States
Wall	Georgian Bay,  Ontario	 Canada
Wall	 Western Australia	 Australia
Wallis	 Wallis and Futuna	 France
Walpole	 Ontario	 Canada
Walrus	Pribilof Islands,  Alaska	 United States
Water Cay	Bahamas,  Turks and Caicos Islands	 United Kingdom
Water Cay	Bahamas	 Bahamas
Water Cay	Lesser Antilles,  U.S. Virgin Islands	 United States
Watermelon Cay	Lesser Antilles,  U.S. Virgin Islands	 United States
Wangerooge	East Frisian Islands,  Lower Saxony	 Germany
Warbah	Persian Gulf	 Kuwait
Ward	 Rhode Island	 United States
Ward's	Boston Harbor,  Massachusetts	 United States
Wards	East River,  New York	 United States
Warnie Kępy	Oder Lagoon islands	 Poland
Washington	Lake Michigan,  Wisconsin	 United States
Washington	 New York	 United States
Washington	 Minnesota	 United States
Washington	 Michigan	 United States
Washington's Landing	Allegheny River,  Pennsylvania	 United States
Watford	 Bermuda	 United Kingdom
Watkins	Potomac River,  Maryland	 United States
Watling	 Bermuda	 United Kingdom
Watling	Bahamas	 Bahamas
Watson	Biscayne Bay,  Florida	 United States
Wax Cay	Bahamas	 Bahamas
Wayland	Thimble Islands,  Connecticut	 United States
Weatherford Cay	Bahamas	 Bahamas
Weddell	 Falkland Islands	 United Kingdom
Weepecket	Elizabeth Islands,  Massachusetts	 United States
Welk Rocks	Lesser Antilles,  U.S. Virgin Islands	 United States
Well Cay	Bahamas	 Bahamas
Wellesley	Lake Rosseau  Ontario	 Canada
Wellesley	Thousand Islands, St. Lawrence River,  New York	 United States
Wellington Island	 Antártica Chilena Province	 Chile
Wells	Ohio River,  West Virginia	 United States
West Brother	The Brothers,  Hong Kong	 China
West Caicos	Bahamas,  Turks and Caicos Islands	 United Kingdom
West Cay	Bahamas	 Bahamas
West Cay	Leeward Islands of the Lesser Antilles,  Anguilla	 United Kingdom
West Cay	Lesser Antilles,  U.S. Virgin Islands	 United States
West Crib	Thimble Islands,  Connecticut	 United States
West	 Rhode Island	 United States
West Dog	 British Virgin Islands	 United Kingdom
West Falkland	 Falkland Islands	 United Kingdom
West Linga	 Shetland Islands	 Scotland
West Point	 Falkland Islands	 United Kingdom
West Sand Spit	Bahamas,  Turks and Caicos Islands	 United Kingdom
West Ship	 Mississippi	 United States
West Shroud Cay	Bahamas	 Bahamas
West Sister	Lake Erie,  Ohio	 United States
West Summerland Key	Florida Keys,  Florida	 United States
West York	Spratley Islands	Disputed between:
 China,
 Republic of China,
 Vietnam,
 Brunei,
 Philippines, and
 Malaysia
Westcott	 Bermuda	 United Kingdom
Western	Georgian Bay,  Ontario	 Canada
Western Duck	Lake Huron,  Ontario	 Canada
Westham	 British Columbia	 Canada
Weston	James Bay,  Nunavut	 Canada
Westport	Mississippi River,  Missouri	 United States
Westray	The North Isles,  Orkney Islands	 Scotland
Wet Cay	Bahamas	 Bahamas
Wetar	Maluku Islands	 Indonesia
Whakaari	Bay of Plenty	 New Zealand
Whale Cay	Bahamas	 Bahamas
Whale	 Bermuda	 United Kingdom
Whale	Bay of Plenty	 New Zealand
Whaelback	 New Hampshire	 United States
Whalers	 Bermuda	 United Kingdom
Whalsay	 Shetland Islands	 Scotland
Whanganui	Hauraki Gulf	 New Zealand
Wheatland Bar	Willamette River,  Oregon	 United States
Wheeler	Kanawha River,  West Virginia	 United States
Wheeling	Ohio River,  West Virginia	 United States
Whidbey	Puget Sound,  Washington	 United States
Whistling Cay	Lesser Antilles,  U.S. Virgin Islands	 United States
White Cay	Bahamas	 Bahamas
White Cay	Bahamas,  Turks and Caicos Islands	 United Kingdom
White	Otago	 New Zealand
White	Bay of Plenty	 New Zealand
Whitsunday	Whitsunday Islands	 Australia
White	Lower Lough Erne, Northern Ireland	 United Kingdom
White	 Nunavut	 Canada
White	Windward Islands of the Lesser Antilles	 Grenada
White		Antarctica
White	Ross Archipelago	Antarctica
White	Isles of Shoals,  New Hampshire	 United States
White	 Bermuda	 United Kingdom
White	 Bermuda	 United Kingdom
White Bay Cay	Bahamas	 Bahamas
White Cloud	Georgian Bay,  Ontario	 Canada
Whitefish	Lake Huron  Ontario	 Canada
White Head	 New Brunswick	 Canada
Wicked Will	Leeward Islands of the Lesser Antilles	 Antigua and Barbuda
Wiegand	Belcher Islands,  Nunavut	 Canada
Wild Horse	Flathead Lake,  Montana	 United States
Wielki Krzek	Oder Lagoon islands	 Poland
Wight	British Isles	 United Kingdom
Wilhelmøya	Svalbard	 Norway
Wilkes	Wake Island, Pacific Ocean	 United States
Willemberg	Lesser Antilles,  Netherlands Antilles	 Kingdom of the Netherlands
Williams	Tennessee River,  Tennessee	 United States
Williamson	Ohio River,  West Virginia	 United States
Willingdon	Kochi, Kerala	 India
Willow	Willamette River,  Oregon	 United States
Wilmington	Kankakee River,  Illinois	 United States
Wilson Cay	Bahamas	 Bahamas
Wilson	 Bermuda	 United Kingdom
Wilson	Kanawha River,  West Virginia	 United States
Wiltshires Cay	Bahamas	 Bahamas
Windermere	Bahamas	 Bahamas
Windley	Florida Keys,  Florida	 United States
Windsor	Willamette River,  Oregon	 United States
Wislow	Fox Islands group of the Aleutian Islands,  Alaska	 United States
Wiszowa Kępa	Oder Lagoon islands	 Poland
Witten Towhead	Ohio River,  West Virginia	 United States
Wizard	Crater Lake,  Oregon	 United States
Wolfe	Lake Ontario,  Ontario	 Canada
Wolin	Baltic Sea	 Poland
Wong Wan Chau	 Hong Kong	 China
Wood Cay	Bahamas	 Bahamas
Woods	Lake Champlain,  Vermont	 United States
Woolen Dean Cay	Bahamas	 Bahamas
Wotho Atoll	Ralik Chain	 Marshall Islands
Wotje Atoll		 Marshall Islands
Wrangel	Chukotka Autonomous Okrug	 Russia
Wrangell	Alexander Archipelago,  Alaska	 United States
Wreck	Georgian Bay,  Ontario	 Canada
Wuvulu	Bismarck Archipelago	 Papua New Guinea
Wydrza Kępa	Oder Lagoon islands	 Poland
Wyre	The North Isles,  Orkney Islands	 Scotland
Xiushan	Zhoushan Archipelago	 China
Yakushima	Osumi Islands part of the Satsunan Islands part of the Ryukyu Islands	 Japan
Isla Yallis	Vieques,  Puerto Rico	 United States
Yelagin	Neva River	 Russia
Yell	 Shetland Islands	 Scotland
Yellow	Bahamas	 Bahamas
Cayo Yerba	Culebra,  Puerto Rico	 United States
Yerba Buena	San Francisco Bay,  California	 United States
Yeo	Lake Huron,  Ontario	 Canada
Yeoman Island	 Nunavut	 Canada
Yeongjong	Incheon	 South Korea
Yeoseodo		 South Korea
Yeouido	Han River	 South Korea
Yijiangshan	Taiwan Strait	 China
Ynys Benlas	North Wales	 Wales
Ynys Castell	North Wales	 Wales
Ynys Feurig	North Wales	 Wales
Ynys Gaint	North Wales	 Wales
Ynys Gored Goch	North Wales	 Wales
Ynys Llanddwyn	North Wales	 Wales
Ynys y Bîg	North Wales	 Wales
Yonaguni	Yaeyama Islands part of the Sakishima Islands part of the Ryukyu Islands	 Japan
York	Apostle Islands,  Wisconsin	 United States
York	 Arkansas	 United States
York	Leeward Islands of the Lesser Antilles	 Antigua and Barbuda
Yoronjima	Amami Islands part of the Satsunan Islands part of the Ryukyu Islands	 Japan
Yoroshima	Amami Islands part of the Satsunan Islands part of the Ryukyu Islands	 Japan
Young Cay	Bahamas	 Bahamas
Young	 Vermont	 United States
Young	Balleny Islands	Ross Dependency,  New Zealand
Young		 Saint Vincent and the Grenadines
Youngs	 Alabama	 United States
Youngs	 Alabama	 United States
Yubujima	Yaeyama Islands part of the Sakishima Islands part of the Ryukyu Islands	 Japan
Yuma	Bahamas	 Bahamas
Yunaska	Islands of Four Mountains,  Alaska	 United States
Yuzhny	Novaya Zemlya, Arkhangelsk Oblast	 Russia
Zakynthos	Ionian Islands	 Greece
Zamamijima	Kerama Islands part of the Okinawa Islands part of the Ryukyu Islands	 Japan
Ile Zanguille		 Seychelles
Zanzibar 		 Tanzania
Zave		 Seychelles
Zealand		 Denmark
Zembra		 Tunisia
Zha Xi	Lake Basum Tso, Tibet	 China
Zhenbao	Ussuri River	 China
Zhifu	Bohai Sea	 China
Zhokova	De Long Islands	 Russia
Zhongshan Dao	Pearl River Delta,  Macau	 China
Zhoushan	Zhoushan Archipelago	 China
Zhujiajian	Zhoushan Archipelago	 China
Zlarin		 Croatia
Zug	River Rouge,  Michigan	 United States
Zuid-Beveland	 Zeeland	 Netherlands
Żuławy	Islands of Gdańsk Bay	 Poland
Zuqar	Red Sea	Disputed between  Eritrea and  Yemen